"BA Code","Timestamp (Hour Ending)","Demand (MWh)","Demand Forecast (MWh)","Net Generation (MWh)","Total Interchange (MWh)"
SOCO,"1/1/2024 12 a.m. CST",25124,24787,26316,1192
SOCO,"1/1/2024 1 a.m. CST",25181,24570,26342,1161
SOCO,"1/1/2024 2 a.m. CST",25567,24499,26657,1090
SOCO,"1/1/2024 3 a.m. CST",25573,24501,26786,1213
SOCO,"1/1/2024 4 a.m. CST",25481,24801,26641,1160
SOCO,"1/1/2024 5 a.m. CST",25724,25386,26573,849
SOCO,"1/1/2024 6 a.m. CST",26514,26194,27457,943
SOCO,"1/1/2024 7 a.m. CST",27203,26874,28342,1139
SOCO,"1/1/2024 8 a.m. CST",27372,27141,28334,962
SOCO,"1/1/2024 9 a.m. CST",27055,26808,28016,961
SOCO,"1/1/2024 10 a.m. CST",26519,26296,27000,481
SOCO,"1/1/2024 11 a.m. CST",26217,25689,26853,636
SOCO,"1/1/2024 12 p.m. CST",25381,24828,26176,795
SOCO,"1/1/2024 1 p.m. CST",24956,24060,25742,786
SOCO,"1/1/2024 2 p.m. CST",24315,23392,25230,915
SOCO,"1/1/2024 3 p.m. CST",23699,23176,24865,1166
SOCO,"1/1/2024 4 p.m. CST",24282,23726,25357,1075
SOCO,"1/1/2024 5 p.m. CST",25121,25012,25919,798
SOCO,"1/1/2024 6 p.m. CST",26905,26708,27606,701
SOCO,"1/1/2024 7 p.m. CST",27400,27271,28427,1027
SOCO,"1/1/2024 8 p.m. CST",27544,27352,28517,973
SOCO,"1/1/2024 9 p.m. CST",27906,27700,29014,1108
SOCO,"1/1/2024 10 p.m. CST",27331,27124,28537,1206
SOCO,"1/1/2024 11 p.m. CST",26831,26608,27899,1068
SOCO,"1/2/2024 12 a.m. CST",26869,26308,27685,816
SOCO,"1/2/2024 1 a.m. CST",27321,26412,27941,620
SOCO,"1/2/2024 2 a.m. CST",27704,26784,28238,534
SOCO,"1/2/2024 3 a.m. CST",28080,27503,28593,513
SOCO,"1/2/2024 4 a.m. CST",28983,28767,29745,762
SOCO,"1/2/2024 5 a.m. CST",30733,30488,31128,395
SOCO,"1/2/2024 6 a.m. CST",33174,32888,33342,168
SOCO,"1/2/2024 7 a.m. CST",35343,35150,35164,-179
SOCO,"1/2/2024 8 a.m. CST",36086,35905,35974,-112
SOCO,"1/2/2024 9 a.m. CST",34687,34499,34639,-48
SOCO,"1/2/2024 10 a.m. CST",32748,32464,32848,100
SOCO,"1/2/2024 11 a.m. CST",31275,30681,31435,160
SOCO,"1/2/2024 12 p.m. CST",30439,29221,30657,218
SOCO,"1/2/2024 1 p.m. CST",29243,28024,29532,289
SOCO,"1/2/2024 2 p.m. CST",28622,27090,29055,433
SOCO,"1/2/2024 3 p.m. CST",27576,26409,28297,721
SOCO,"1/2/2024 4 p.m. CST",27602,26627,28405,803
SOCO,"1/2/2024 5 p.m. CST",28095,27886,29046,951
SOCO,"1/2/2024 6 p.m. CST",30328,30102,30982,654
SOCO,"1/2/2024 7 p.m. CST",31301,31040,31834,533
SOCO,"1/2/2024 8 p.m. CST",31740,31467,32062,322
SOCO,"1/2/2024 9 p.m. CST",31672,31407,32318,646
SOCO,"1/2/2024 10 p.m. CST",31165,30905,32072,907
SOCO,"1/2/2024 11 p.m. CST",30789,30316,31227,438
SOCO,"1/3/2024 12 a.m. CST",30337,29856,30737,400
SOCO,"1/3/2024 1 a.m. CST",30772,29908,30792,20
SOCO,"1/3/2024 2 a.m. CST",31057,30178,31058,1
SOCO,"1/3/2024 3 a.m. CST",31540,30700,31500,-40
SOCO,"1/3/2024 4 a.m. CST",31993,31657,31985,-8
SOCO,"1/3/2024 5 a.m. CST",33291,33079,33290,-1
SOCO,"1/3/2024 6 a.m. CST",35257,35112,35206,-51
SOCO,"1/3/2024 7 a.m. CST",36744,36588,36784,40
SOCO,"1/3/2024 8 a.m. CST",36628,36493,36656,28
SOCO,"1/3/2024 9 a.m. CST",35606,35456,35301,-305
SOCO,"1/3/2024 10 a.m. CST",34157,33967,33836,-321
SOCO,"1/3/2024 11 a.m. CST",33467,32982,33112,-355
SOCO,"1/3/2024 12 p.m. CST",33035,32212,32496,-539
SOCO,"1/3/2024 1 p.m. CST",32874,31550,32406,-468
SOCO,"1/3/2024 2 p.m. CST",32296,30972,31957,-339
SOCO,"1/3/2024 3 p.m. CST",32101,30782,31802,-299
SOCO,"1/3/2024 4 p.m. CST",32322,30982,32239,-83
SOCO,"1/3/2024 5 p.m. CST",32344,31746,32646,302
SOCO,"1/3/2024 6 p.m. CST",33109,32896,33331,222
SOCO,"1/3/2024 7 p.m. CST",33002,32754,33207,205
SOCO,"1/3/2024 8 p.m. CST",32499,32240,32585,86
SOCO,"1/3/2024 9 p.m. CST",31641,31389,31824,183
SOCO,"1/3/2024 10 p.m. CST",30338,30108,30457,119
SOCO,"1/3/2024 11 p.m. CST",29729,28894,29306,-423
SOCO,"1/4/2024 12 a.m. CST",29241,28352,28918,-323
SOCO,"1/4/2024 1 a.m. CST",29381,28178,29201,-180
SOCO,"1/4/2024 2 a.m. CST",29702,28436,29619,-83
SOCO,"1/4/2024 3 a.m. CST",30293,29038,30278,-15
SOCO,"1/4/2024 4 a.m. CST",30771,29960,30771,0
SOCO,"1/4/2024 5 a.m. CST",31897,31634,31909,12
SOCO,"1/4/2024 6 a.m. CST",34368,34133,34012,-356
SOCO,"1/4/2024 7 a.m. CST",36248,36128,36168,-80
SOCO,"1/4/2024 8 a.m. CST",36280,36089,36287,7
SOCO,"1/4/2024 9 a.m. CST",34516,34411,34395,-121
SOCO,"1/4/2024 10 a.m. CST",32484,32342,32449,-35
SOCO,"1/4/2024 11 a.m. CST",31388,30548,31490,102
SOCO,"1/4/2024 12 p.m. CST",30112,29057,30420,308
SOCO,"1/4/2024 1 p.m. CST",28992,27943,29465,473
SOCO,"1/4/2024 2 p.m. CST",28053,27020,28701,648
SOCO,"1/4/2024 3 p.m. CST",27367,26384,28112,745
SOCO,"1/4/2024 4 p.m. CST",27219,26614,28080,861
SOCO,"1/4/2024 5 p.m. CST",28513,27917,29425,912
SOCO,"1/4/2024 6 p.m. CST",30508,30188,31245,737
SOCO,"1/4/2024 7 p.m. CST",31382,31127,32115,733
SOCO,"1/4/2024 8 p.m. CST",31830,31571,32326,496
SOCO,"1/4/2024 9 p.m. CST",31750,31472,32310,560
SOCO,"1/4/2024 10 p.m. CST",31191,30932,31861,670
SOCO,"1/4/2024 11 p.m. CST",30661,30150,30979,318
SOCO,"1/5/2024 12 a.m. CST",30035,29767,30568,533
SOCO,"1/5/2024 1 a.m. CST",30238,29777,30507,269
SOCO,"1/5/2024 2 a.m. CST",30897,30057,31145,248
SOCO,"1/5/2024 3 a.m. CST",31263,30428,31656,393
SOCO,"1/5/2024 4 a.m. CST",31311,31102,32079,768
SOCO,"1/5/2024 5 a.m. CST",32832,32630,33518,686
SOCO,"1/5/2024 6 a.m. CST",35079,34903,35983,904
SOCO,"1/5/2024 7 a.m. CST",36693,36581,37433,740
SOCO,"1/5/2024 8 a.m. CST",36421,36433,37431,1010
SOCO,"1/5/2024 9 a.m. CST",34534,34842,35521,987
SOCO,"1/5/2024 10 a.m. CST",32347,32660,33118,771
SOCO,"1/5/2024 11 a.m. CST",30506,30631,31236,730
SOCO,"1/5/2024 12 p.m. CST",29411,29031,29983,572
SOCO,"1/5/2024 1 p.m. CST",28288,27814,29179,891
SOCO,"1/5/2024 2 p.m. CST",27530,27048,28324,794
SOCO,"1/5/2024 3 p.m. CST",27231,26681,28146,915
SOCO,"1/5/2024 4 p.m. CST",27321,26898,28451,1130
SOCO,"1/5/2024 5 p.m. CST",28213,27909,29746,1533
SOCO,"1/5/2024 6 p.m. CST",29207,28915,30774,1567
SOCO,"1/5/2024 7 p.m. CST",29128,28847,30664,1536
SOCO,"1/5/2024 8 p.m. CST",28680,28411,30034,1354
SOCO,"1/5/2024 9 p.m. CST",27951,27711,29407,1456
SOCO,"1/5/2024 10 p.m. CST",26898,26688,28551,1653
SOCO,"1/5/2024 11 p.m. CST",25933,25580,27113,1180
SOCO,"1/6/2024 12 a.m. CST",25055,24699,26345,1290
SOCO,"1/6/2024 1 a.m. CST",24546,23996,26095,1549
SOCO,"1/6/2024 2 a.m. CST",24241,23690,25800,1559
SOCO,"1/6/2024 3 a.m. CST",23945,23393,25558,1613
SOCO,"1/6/2024 4 a.m. CST",23903,23368,25421,1518
SOCO,"1/6/2024 5 a.m. CST",24213,23706,25357,1144
SOCO,"1/6/2024 6 a.m. CST",24444,24156,25633,1189
SOCO,"1/6/2024 7 a.m. CST",25246,24928,26520,1274
SOCO,"1/6/2024 8 a.m. CST",25881,25574,27206,1325
SOCO,"1/6/2024 9 a.m. CST",26724,26425,27966,1242
SOCO,"1/6/2024 10 a.m. CST",27051,26728,28300,1249
SOCO,"1/6/2024 11 a.m. CST",26930,26662,28210,1280
SOCO,"1/6/2024 12 p.m. CST",26705,26241,28081,1376
SOCO,"1/6/2024 1 p.m. CST",26691,25772,28133,1442
SOCO,"1/6/2024 2 p.m. CST",26282,25289,27817,1535
SOCO,"1/6/2024 3 p.m. CST",25996,25031,27619,1623
SOCO,"1/6/2024 4 p.m. CST",25710,25116,27363,1653
SOCO,"1/6/2024 5 p.m. CST",25803,25650,27500,1697
SOCO,"1/6/2024 6 p.m. CST",26714,26525,28426,1712
SOCO,"1/6/2024 7 p.m. CST",26774,26524,28250,1476
SOCO,"1/6/2024 8 p.m. CST",26511,26287,28081,1570
SOCO,"1/6/2024 9 p.m. CST",26105,25876,27737,1632
SOCO,"1/6/2024 10 p.m. CST",25464,25184,26643,1179
SOCO,"1/6/2024 11 p.m. CST",24754,24498,25337,583
SOCO,"1/7/2024 12 a.m. CST",24158,23890,24586,428
SOCO,"1/7/2024 1 a.m. CST",24071,23473,24381,310
SOCO,"1/7/2024 2 a.m. CST",23896,23238,24157,261
SOCO,"1/7/2024 3 a.m. CST",23878,23234,24169,291
SOCO,"1/7/2024 4 a.m. CST",24260,23583,24569,309
SOCO,"1/7/2024 5 a.m. CST",24409,24103,24983,574
SOCO,"1/7/2024 6 a.m. CST",25132,24886,25585,453
SOCO,"1/7/2024 7 a.m. CST",26328,26081,26880,552
SOCO,"1/7/2024 8 a.m. CST",27478,27226,28092,614
SOCO,"1/7/2024 9 a.m. CST",28169,27801,28738,569
SOCO,"1/7/2024 10 a.m. CST",27816,27505,28341,525
SOCO,"1/7/2024 11 a.m. CST",27539,26885,27851,312
SOCO,"1/7/2024 12 p.m. CST",26850,26174,27208,358
SOCO,"1/7/2024 1 p.m. CST",26265,25574,26502,237
SOCO,"1/7/2024 2 p.m. CST",25781,25139,26135,354
SOCO,"1/7/2024 3 p.m. CST",25570,24890,26070,500
SOCO,"1/7/2024 4 p.m. CST",25891,25200,26498,607
SOCO,"1/7/2024 5 p.m. CST",26932,26573,27420,488
SOCO,"1/7/2024 6 p.m. CST",28947,28604,29421,474
SOCO,"1/7/2024 7 p.m. CST",29798,29432,30170,372
SOCO,"1/7/2024 8 p.m. CST",30044,29686,30258,214
SOCO,"1/7/2024 9 p.m. CST",29846,29484,30137,291
SOCO,"1/7/2024 10 p.m. CST",29165,28816,29340,175
SOCO,"1/7/2024 11 p.m. CST",28489,28121,28553,64
SOCO,"1/8/2024 12 a.m. CST",28025,27696,27903,-122
SOCO,"1/8/2024 1 a.m. CST",28554,27653,28214,-340
SOCO,"1/8/2024 2 a.m. CST",28812,27890,28363,-449
SOCO,"1/8/2024 3 a.m. CST",28841,28284,28738,-103
SOCO,"1/8/2024 4 a.m. CST",29549,29083,30053,504
SOCO,"1/8/2024 5 a.m. CST",30892,30706,31411,519
SOCO,"1/8/2024 6 a.m. CST",33229,33019,33499,270
SOCO,"1/8/2024 7 a.m. CST",34758,34636,35056,298
SOCO,"1/8/2024 8 a.m. CST",34561,34448,34884,323
SOCO,"1/8/2024 9 a.m. CST",33884,33659,33971,87
SOCO,"1/8/2024 10 a.m. CST",32895,32715,33253,358
SOCO,"1/8/2024 11 a.m. CST",31577,31395,31665,88
SOCO,"1/8/2024 12 p.m. CST",30974,30440,30954,-20
SOCO,"1/8/2024 1 p.m. CST",30582,29461,30552,-30
SOCO,"1/8/2024 2 p.m. CST",29966,28661,30175,209
SOCO,"1/8/2024 3 p.m. CST",29454,28316,29743,289
SOCO,"1/8/2024 4 p.m. CST",29290,28657,29960,670
SOCO,"1/8/2024 5 p.m. CST",30106,29899,31176,1070
SOCO,"1/8/2024 6 p.m. CST",31361,31159,32311,950
SOCO,"1/8/2024 7 p.m. CST",31182,30992,32050,868
SOCO,"1/8/2024 8 p.m. CST",30268,30087,31019,751
SOCO,"1/8/2024 9 p.m. CST",29214,29017,30359,1145
SOCO,"1/8/2024 10 p.m. CST",27646,27473,28669,1023
SOCO,"1/8/2024 11 p.m. CST",26388,26120,26590,202
SOCO,"1/9/2024 12 a.m. CST",25489,24988,25686,197
SOCO,"1/9/2024 1 a.m. CST",24774,24106,25166,392
SOCO,"1/9/2024 2 a.m. CST",24227,23565,24591,364
SOCO,"1/9/2024 3 a.m. CST",23864,23211,24260,396
SOCO,"1/9/2024 4 a.m. CST",23900,23267,24436,536
SOCO,"1/9/2024 5 a.m. CST",24419,23879,24847,428
SOCO,"1/9/2024 6 a.m. CST",25355,25095,25915,560
SOCO,"1/9/2024 7 a.m. CST",26649,26385,27417,768
SOCO,"1/9/2024 8 a.m. CST",27037,26775,27630,593
SOCO,"1/9/2024 9 a.m. CST",27370,27071,27934,564
SOCO,"1/9/2024 10 a.m. CST",27439,27201,28184,745
SOCO,"1/9/2024 11 a.m. CST",27395,27117,28122,727
SOCO,"1/9/2024 12 p.m. CST",27220,26946,27904,684
SOCO,"1/9/2024 1 p.m. CST",27189,26709,28165,976
SOCO,"1/9/2024 2 p.m. CST",26936,26304,27911,975
SOCO,"1/9/2024 3 p.m. CST",26628,26009,27683,1055
SOCO,"1/9/2024 4 p.m. CST",26980,26444,28237,1257
SOCO,"1/9/2024 5 p.m. CST",27881,27595,28838,957
SOCO,"1/9/2024 6 p.m. CST",29525,29166,30814,1289
SOCO,"1/9/2024 7 p.m. CST",30051,29756,31326,1275
SOCO,"1/9/2024 8 p.m. CST",30020,29619,31101,1081
SOCO,"1/9/2024 9 p.m. CST",29461,29106,30470,1009
SOCO,"1/9/2024 10 p.m. CST",28572,28190,29759,1187
SOCO,"1/9/2024 11 p.m. CST",27555,27194,28703,1148
SOCO,"1/10/2024 12 a.m. CST",27466,26255,28494,1028
SOCO,"1/10/2024 1 a.m. CST",27285,26238,27836,551
SOCO,"1/10/2024 2 a.m. CST",27316,26375,27684,368
SOCO,"1/10/2024 3 a.m. CST",27687,26716,27999,312
SOCO,"1/10/2024 4 a.m. CST",28539,27573,28645,106
SOCO,"1/10/2024 5 a.m. CST",29757,29114,29750,-7
SOCO,"1/10/2024 6 a.m. CST",31989,31818,32416,427
SOCO,"1/10/2024 7 a.m. CST",33936,33833,34109,173
SOCO,"1/10/2024 8 a.m. CST",33967,33903,34223,256
SOCO,"1/10/2024 9 a.m. CST",32981,32937,33442,461
SOCO,"1/10/2024 10 a.m. CST",31636,31575,31788,152
SOCO,"1/10/2024 11 a.m. CST",30881,30067,31376,495
SOCO,"1/10/2024 12 p.m. CST",29536,28793,30174,638
SOCO,"1/10/2024 1 p.m. CST",28791,27701,29351,560
SOCO,"1/10/2024 2 p.m. CST",28326,26851,28989,663
SOCO,"1/10/2024 3 p.m. CST",27382,26274,28337,955
SOCO,"1/10/2024 4 p.m. CST",27086,26448,28321,1235
SOCO,"1/10/2024 5 p.m. CST",28084,27747,29127,1043
SOCO,"1/10/2024 6 p.m. CST",30194,30026,31071,877
SOCO,"1/10/2024 7 p.m. CST",31254,31073,32159,905
SOCO,"1/10/2024 8 p.m. CST",31570,31355,32281,711
SOCO,"1/10/2024 9 p.m. CST",31347,31115,32145,798
SOCO,"1/10/2024 10 p.m. CST",30495,30119,31054,559
SOCO,"1/10/2024 11 p.m. CST",29574,29109,30169,595
SOCO,"1/11/2024 12 a.m. CST",28901,28459,29434,533
SOCO,"1/11/2024 1 a.m. CST",29015,28210,28852,-163
SOCO,"1/11/2024 2 a.m. CST",29073,28261,28891,-182
SOCO,"1/11/2024 3 a.m. CST",29424,28606,28991,-433
SOCO,"1/11/2024 4 a.m. CST",30077,29428,29276,-801
SOCO,"1/11/2024 5 a.m. CST",31163,30988,30723,-440
SOCO,"1/11/2024 6 a.m. CST",33456,33332,32936,-520
SOCO,"1/11/2024 7 a.m. CST",35143,35147,34528,-615
SOCO,"1/11/2024 8 a.m. CST",34804,34682,33950,-854
SOCO,"1/11/2024 9 a.m. CST",33129,33013,32525,-604
SOCO,"1/11/2024 10 a.m. CST",30963,30884,30487,-476
SOCO,"1/11/2024 11 a.m. CST",29357,28902,28789,-568
SOCO,"1/11/2024 12 p.m. CST",28401,27329,27936,-465
SOCO,"1/11/2024 1 p.m. CST",27246,26200,27051,-195
SOCO,"1/11/2024 2 p.m. CST",26306,25289,26478,172
SOCO,"1/11/2024 3 p.m. CST",25822,24847,25807,-15
SOCO,"1/11/2024 4 p.m. CST",25464,24850,25462,-2
SOCO,"1/11/2024 5 p.m. CST",25929,25651,26038,109
SOCO,"1/11/2024 6 p.m. CST",27409,27364,27535,126
SOCO,"1/11/2024 7 p.m. CST",28088,27984,28190,102
SOCO,"1/11/2024 8 p.m. CST",28208,28005,28417,209
SOCO,"1/11/2024 9 p.m. CST",27683,27559,27708,25
SOCO,"1/11/2024 10 p.m. CST",26862,26576,26709,-153
SOCO,"1/11/2024 11 p.m. CST",25988,25571,25762,-226
SOCO,"1/12/2024 12 a.m. CST",25485,24935,25502,17
SOCO,"1/12/2024 1 a.m. CST",25670,24539,25411,-259
SOCO,"1/12/2024 2 a.m. CST",25464,24412,25242,-222
SOCO,"1/12/2024 3 a.m. CST",25545,24488,25088,-457
SOCO,"1/12/2024 4 a.m. CST",25781,24997,25386,-395
SOCO,"1/12/2024 5 a.m. CST",26388,26224,26262,-126
SOCO,"1/12/2024 6 a.m. CST",28178,27990,28074,-104
SOCO,"1/12/2024 7 a.m. CST",29420,29277,29489,69
SOCO,"1/12/2024 8 a.m. CST",29338,29250,29089,-249
SOCO,"1/12/2024 9 a.m. CST",29285,29197,29087,-198
SOCO,"1/12/2024 10 a.m. CST",29103,28966,29113,10
SOCO,"1/12/2024 11 a.m. CST",28889,28784,28865,-24
SOCO,"1/12/2024 12 p.m. CST",29005,28522,29290,285
SOCO,"1/12/2024 1 p.m. CST",28778,28239,28741,-37
SOCO,"1/12/2024 2 p.m. CST",28645,27759,28315,-330
SOCO,"1/12/2024 3 p.m. CST",27910,27209,27722,-188
SOCO,"1/12/2024 4 p.m. CST",26999,26830,27046,47
SOCO,"1/12/2024 5 p.m. CST",27001,26899,27077,76
SOCO,"1/12/2024 6 p.m. CST",27247,27183,27486,239
SOCO,"1/12/2024 7 p.m. CST",27047,26909,27202,155
SOCO,"1/12/2024 8 p.m. CST",26708,26432,26789,81
SOCO,"1/12/2024 9 p.m. CST",26173,25826,26299,126
SOCO,"1/12/2024 10 p.m. CST",25348,25027,25442,94
SOCO,"1/12/2024 11 p.m. CST",24628,24274,24571,-57
SOCO,"1/13/2024 12 a.m. CST",24170,23815,24246,76
SOCO,"1/13/2024 1 a.m. CST",24019,23675,25120,1101
SOCO,"1/13/2024 2 a.m. CST",24498,23933,25274,776
SOCO,"1/13/2024 3 a.m. CST",25149,24579,25934,785
SOCO,"1/13/2024 4 a.m. CST",25953,25496,26807,854
SOCO,"1/13/2024 5 a.m. CST",26791,26704,27536,745
SOCO,"1/13/2024 6 a.m. CST",28379,28196,29096,717
SOCO,"1/13/2024 7 a.m. CST",30208,29948,30817,609
SOCO,"1/13/2024 8 a.m. CST",31690,31591,32350,660
SOCO,"1/13/2024 9 a.m. CST",32016,32064,33014,998
SOCO,"1/13/2024 10 a.m. CST",31219,31325,31930,711
SOCO,"1/13/2024 11 a.m. CST",30384,30105,30706,322
SOCO,"1/13/2024 12 p.m. CST",29374,28753,29941,567
SOCO,"1/13/2024 1 p.m. CST",28039,27407,28406,367
SOCO,"1/13/2024 2 p.m. CST",26504,26232,27155,651
SOCO,"1/13/2024 3 p.m. CST",25966,25683,26702,736
SOCO,"1/13/2024 4 p.m. CST",25844,25816,26364,520
SOCO,"1/13/2024 5 p.m. CST",27011,26973,27365,354
SOCO,"1/13/2024 6 p.m. CST",29200,29138,29567,367
SOCO,"1/13/2024 7 p.m. CST",30201,30132,30761,560
SOCO,"1/13/2024 8 p.m. CST",30604,30555,31228,624
SOCO,"1/13/2024 9 p.m. CST",30802,30710,31376,574
SOCO,"1/13/2024 10 p.m. CST",30447,30368,30999,552
SOCO,"1/13/2024 11 p.m. CST",29924,29829,30506,582
SOCO,"1/14/2024 12 a.m. CST",29825,29411,30510,685
SOCO,"1/14/2024 1 a.m. CST",29736,29275,30338,602
SOCO,"1/14/2024 2 a.m. CST",29808,29352,30444,636
SOCO,"1/14/2024 3 a.m. CST",30066,29603,30590,524
SOCO,"1/14/2024 4 a.m. CST",30180,30062,30634,454
SOCO,"1/14/2024 5 a.m. CST",31077,30971,31938,861
SOCO,"1/14/2024 6 a.m. CST",32277,32158,33209,932
SOCO,"1/14/2024 7 a.m. CST",33609,33463,34557,948
SOCO,"1/14/2024 8 a.m. CST",34491,34363,35776,1285
SOCO,"1/14/2024 9 a.m. CST",33250,33139,34546,1296
SOCO,"1/14/2024 10 a.m. CST",30430,30313,31228,798
SOCO,"1/14/2024 11 a.m. CST",28234,27991,29253,1019
SOCO,"1/14/2024 12 p.m. CST",27247,26428,28875,1628
SOCO,"1/14/2024 1 p.m. CST",26143,25328,27963,1820
SOCO,"1/14/2024 2 p.m. CST",25719,24570,27689,1970
SOCO,"1/14/2024 3 p.m. CST",25232,24096,27187,1955
SOCO,"1/14/2024 4 p.m. CST",25170,24261,27253,2083
SOCO,"1/14/2024 5 p.m. CST",25474,25115,27153,1679
SOCO,"1/14/2024 6 p.m. CST",26917,26932,28681,1764
SOCO,"1/14/2024 7 p.m. CST",27689,27697,29644,1955
SOCO,"1/14/2024 8 p.m. CST",28004,28023,30017,2013
SOCO,"1/14/2024 9 p.m. CST",27884,27867,29926,2042
SOCO,"1/14/2024 10 p.m. CST",27310,27232,29228,1918
SOCO,"1/14/2024 11 p.m. CST",26586,26534,28281,1695
SOCO,"1/15/2024 12 a.m. CST",26340,25868,27907,1567
SOCO,"1/15/2024 1 a.m. CST",26335,25553,27760,1425
SOCO,"1/15/2024 2 a.m. CST",26398,25527,27640,1242
SOCO,"1/15/2024 3 a.m. CST",26586,25875,27992,1406
SOCO,"1/15/2024 4 a.m. CST",26697,26577,28181,1484
SOCO,"1/15/2024 5 a.m. CST",27874,27755,29853,1979
SOCO,"1/15/2024 6 a.m. CST",29501,29436,31537,2036
SOCO,"1/15/2024 7 a.m. CST",31139,31109,33228,2089
SOCO,"1/15/2024 8 a.m. CST",31810,31766,33972,2162
SOCO,"1/15/2024 9 a.m. CST",31027,31062,33441,2414
SOCO,"1/15/2024 10 a.m. CST",29800,29758,32025,2225
SOCO,"1/15/2024 11 a.m. CST",28616,28555,31166,2550
SOCO,"1/15/2024 12 p.m. CST",27499,27429,30447,2948
SOCO,"1/15/2024 1 p.m. CST",27220,26468,30235,3015
SOCO,"1/15/2024 2 p.m. CST",26653,25836,29765,3112
SOCO,"1/15/2024 3 p.m. CST",26236,25417,29303,3067
SOCO,"1/15/2024 4 p.m. CST",26328,25494,29319,2991
SOCO,"1/15/2024 5 p.m. CST",26775,26317,29688,2913
SOCO,"1/15/2024 6 p.m. CST",28162,28100,31135,2973
SOCO,"1/15/2024 7 p.m. CST",28726,28660,31543,2817
SOCO,"1/15/2024 8 p.m. CST",28608,28564,31403,2795
SOCO,"1/15/2024 9 p.m. CST",28107,28058,31206,3099
SOCO,"1/15/2024 10 p.m. CST",27127,27021,30371,3244
SOCO,"1/15/2024 11 p.m. CST",26179,26044,29286,3107
SOCO,"1/16/2024 12 a.m. CST",25521,25386,28547,3026
SOCO,"1/16/2024 1 a.m. CST",25310,25095,27738,2428
SOCO,"1/16/2024 2 a.m. CST",25253,24974,27812,2559
SOCO,"1/16/2024 3 a.m. CST",25668,25401,28177,2509
SOCO,"1/16/2024 4 a.m. CST",26539,26286,28845,2306
SOCO,"1/16/2024 5 a.m. CST",28284,28024,30816,2532
SOCO,"1/16/2024 6 a.m. CST",30915,30687,33458,2543
SOCO,"1/16/2024 7 a.m. CST",33224,33002,35899,2675
SOCO,"1/16/2024 8 a.m. CST",34519,34272,36984,2465
SOCO,"1/16/2024 9 a.m. CST",35833,35549,38158,2325
SOCO,"1/16/2024 10 a.m. CST",36594,36212,38513,1919
SOCO,"1/16/2024 11 a.m. CST",36961,36090,38528,1567
SOCO,"1/16/2024 12 p.m. CST",36486,35480,38046,1560
SOCO,"1/16/2024 1 p.m. CST",35717,34739,37283,1566
SOCO,"1/16/2024 2 p.m. CST",34988,34071,36714,1726
SOCO,"1/16/2024 3 p.m. CST",34297,33810,36245,1948
SOCO,"1/16/2024 4 p.m. CST",34854,34398,37025,2171
SOCO,"1/16/2024 5 p.m. CST",36518,36243,38640,2122
SOCO,"1/16/2024 6 p.m. CST",39591,39326,41150,1559
SOCO,"1/16/2024 7 p.m. CST",40827,40583,42047,1220
SOCO,"1/16/2024 8 p.m. CST",41310,41015,42227,917
SOCO,"1/16/2024 9 p.m. CST",41160,40853,41687,527
SOCO,"1/16/2024 10 p.m. CST",40406,40064,40635,229
SOCO,"1/16/2024 11 p.m. CST",40183,39366,40545,362
SOCO,"1/17/2024 12 a.m. CST",40393,39262,40851,458
SOCO,"1/17/2024 1 a.m. CST",40634,39498,40890,256
SOCO,"1/17/2024 2 a.m. CST",41011,39924,41106,95
SOCO,"1/17/2024 3 a.m. CST",41297,40505,41028,-269
SOCO,"1/17/2024 4 a.m. CST",41835,41476,41982,147
SOCO,"1/17/2024 5 a.m. CST",43557,43199,43833,276
SOCO,"1/17/2024 6 a.m. CST",45755,45470,45729,-26
SOCO,"1/17/2024 7 a.m. CST",47368,47010,47065,-303
SOCO,"1/17/2024 8 a.m. CST",47209,46803,47123,-86
SOCO,"1/17/2024 9 a.m. CST",45293,44969,45178,-115
SOCO,"1/17/2024 10 a.m. CST",42813,42370,42875,62
SOCO,"1/17/2024 11 a.m. CST",40552,39968,41233,681
SOCO,"1/17/2024 12 p.m. CST",38520,37591,38987,467
SOCO,"1/17/2024 1 p.m. CST",36705,35629,36662,-43
SOCO,"1/17/2024 2 p.m. CST",35506,34039,35458,-48
SOCO,"1/17/2024 3 p.m. CST",34532,33152,34340,-192
SOCO,"1/17/2024 4 p.m. CST",34621,33283,34588,-33
SOCO,"1/17/2024 5 p.m. CST",35559,34795,35352,-207
SOCO,"1/17/2024 6 p.m. CST",37576,37318,37224,-352
SOCO,"1/17/2024 7 p.m. CST",38908,38700,38590,-318
SOCO,"1/17/2024 8 p.m. CST",39525,39263,38908,-617
SOCO,"1/17/2024 9 p.m. CST",39386,39120,38232,-1154
SOCO,"1/17/2024 10 p.m. CST",39084,38317,37585,-1499
SOCO,"1/17/2024 11 p.m. CST",38452,37557,36997,-1455
SOCO,"1/18/2024 12 a.m. CST",38008,37110,36652,-1356
SOCO,"1/18/2024 1 a.m. CST",37793,36999,36903,-890
SOCO,"1/18/2024 2 a.m. CST",37943,37195,37076,-867
SOCO,"1/18/2024 3 a.m. CST",37882,37488,36448,-1434
SOCO,"1/18/2024 4 a.m. CST",38495,38201,37051,-1444
SOCO,"1/18/2024 5 a.m. CST",40053,39821,39247,-806
SOCO,"1/18/2024 6 a.m. CST",42371,42196,42075,-296
SOCO,"1/18/2024 7 a.m. CST",43927,43670,43220,-707
SOCO,"1/18/2024 8 a.m. CST",43132,42947,42848,-284
SOCO,"1/18/2024 9 a.m. CST",40380,40235,40788,408
SOCO,"1/18/2024 10 a.m. CST",37524,37220,38088,564
SOCO,"1/18/2024 11 a.m. CST",34999,34696,36115,1116
SOCO,"1/18/2024 12 p.m. CST",33666,32697,34667,1001
SOCO,"1/18/2024 1 p.m. CST",32636,31212,33792,1156
SOCO,"1/18/2024 2 p.m. CST",31667,30127,32966,1299
SOCO,"1/18/2024 3 p.m. CST",30539,29532,31516,977
SOCO,"1/18/2024 4 p.m. CST",30271,29630,31131,860
SOCO,"1/18/2024 5 p.m. CST",30821,30517,31651,830
SOCO,"1/18/2024 6 p.m. CST",32176,31925,32873,697
SOCO,"1/18/2024 7 p.m. CST",32400,32126,33125,725
SOCO,"1/18/2024 8 p.m. CST",31963,31694,32429,466
SOCO,"1/18/2024 9 p.m. CST",31000,30714,31474,474
SOCO,"1/18/2024 10 p.m. CST",29519,29239,29912,393
SOCO,"1/18/2024 11 p.m. CST",27981,27744,28315,334
SOCO,"1/19/2024 12 a.m. CST",26685,26633,27598,913
SOCO,"1/19/2024 1 a.m. CST",26182,25932,27340,1158
SOCO,"1/19/2024 2 a.m. CST",25797,25554,26936,1139
SOCO,"1/19/2024 3 a.m. CST",25656,25439,26848,1192
SOCO,"1/19/2024 4 a.m. CST",26142,25942,27313,1171
SOCO,"1/19/2024 5 a.m. CST",27388,27185,28309,921
SOCO,"1/19/2024 6 a.m. CST",29559,29297,30556,997
SOCO,"1/19/2024 7 a.m. CST",31278,31006,32369,1091
SOCO,"1/19/2024 8 a.m. CST",31821,31556,32990,1169
SOCO,"1/19/2024 9 a.m. CST",31804,31582,32881,1077
SOCO,"1/19/2024 10 a.m. CST",31188,30939,32147,959
SOCO,"1/19/2024 11 a.m. CST",30455,30184,31632,1177
SOCO,"1/19/2024 12 p.m. CST",29771,29526,30997,1226
SOCO,"1/19/2024 1 p.m. CST",29455,28892,30559,1104
SOCO,"1/19/2024 2 p.m. CST",29046,28481,30179,1133
SOCO,"1/19/2024 3 p.m. CST",28851,28319,30001,1150
SOCO,"1/19/2024 4 p.m. CST",29322,28753,30391,1069
SOCO,"1/19/2024 5 p.m. CST",30499,30261,31488,989
SOCO,"1/19/2024 6 p.m. CST",32739,32565,33739,1000
SOCO,"1/19/2024 7 p.m. CST",33889,33710,34855,966
SOCO,"1/19/2024 8 p.m. CST",34312,34132,35301,989
SOCO,"1/19/2024 9 p.m. CST",34612,34408,35580,968
SOCO,"1/19/2024 10 p.m. CST",34430,34237,35200,770
SOCO,"1/19/2024 11 p.m. CST",34115,33934,34870,755
SOCO,"1/20/2024 12 a.m. CST",34030,33817,34578,548
SOCO,"1/20/2024 1 a.m. CST",34140,33941,34827,687
SOCO,"1/20/2024 2 a.m. CST",34730,34532,35356,626
SOCO,"1/20/2024 3 a.m. CST",35373,35148,35983,610
SOCO,"1/20/2024 4 a.m. CST",36297,36059,36985,688
SOCO,"1/20/2024 5 a.m. CST",37493,37232,38380,887
SOCO,"1/20/2024 6 a.m. CST",38951,38660,39429,478
SOCO,"1/20/2024 7 a.m. CST",40567,40320,40966,399
SOCO,"1/20/2024 8 a.m. CST",41550,41279,42053,503
SOCO,"1/20/2024 9 a.m. CST",41256,40984,41778,522
SOCO,"1/20/2024 10 a.m. CST",40045,39800,40231,186
SOCO,"1/20/2024 11 a.m. CST",38760,38226,38760,0
SOCO,"1/20/2024 12 p.m. CST",37844,36646,37996,152
SOCO,"1/20/2024 1 p.m. CST",36461,35206,36674,213
SOCO,"1/20/2024 2 p.m. CST",35252,34012,35383,131
SOCO,"1/20/2024 3 p.m. CST",34534,33370,34645,111
SOCO,"1/20/2024 4 p.m. CST",34774,33764,34853,79
SOCO,"1/20/2024 5 p.m. CST",36020,35482,36208,188
SOCO,"1/20/2024 6 p.m. CST",38544,38178,38743,199
SOCO,"1/20/2024 7 p.m. CST",39544,39059,39919,375
SOCO,"1/20/2024 8 p.m. CST",40366,40163,40373,7
SOCO,"1/20/2024 9 p.m. CST",40582,40368,40296,-286
SOCO,"1/20/2024 10 p.m. CST",40199,39918,39379,-820
SOCO,"1/20/2024 11 p.m. CST",40117,39537,39191,-926
SOCO,"1/21/2024 12 a.m. CST",39906,39338,38907,-999
SOCO,"1/21/2024 1 a.m. CST",40033,39465,39403,-630
SOCO,"1/21/2024 2 a.m. CST",40339,39773,39686,-653
SOCO,"1/21/2024 3 a.m. CST",40708,40116,39462,-1246
SOCO,"1/21/2024 4 a.m. CST",41299,40718,39640,-1659
SOCO,"1/21/2024 5 a.m. CST",41853,41560,40654,-1199
SOCO,"1/21/2024 6 a.m. CST",42938,42657,41675,-1263
SOCO,"1/21/2024 7 a.m. CST",44334,44029,43104,-1230
SOCO,"1/21/2024 8 a.m. CST",44952,44611,44261,-691
SOCO,"1/21/2024 9 a.m. CST",43494,43178,42785,-709
SOCO,"1/21/2024 10 a.m. CST",41224,40771,41219,-5
SOCO,"1/21/2024 11 a.m. CST",38997,38146,38727,-270
SOCO,"1/21/2024 12 p.m. CST",37282,35988,37062,-220
SOCO,"1/21/2024 1 p.m. CST",35591,34012,35294,-297
SOCO,"1/21/2024 2 p.m. CST",34336,32474,34026,-310
SOCO,"1/21/2024 3 p.m. CST",33187,31472,32969,-218
SOCO,"1/21/2024 4 p.m. CST",32638,31409,32587,-51
SOCO,"1/21/2024 5 p.m. CST",33177,32659,33172,-5
SOCO,"1/21/2024 6 p.m. CST",35529,35263,35187,-342
SOCO,"1/21/2024 7 p.m. CST",36965,36759,36879,-86
SOCO,"1/21/2024 8 p.m. CST",37636,37414,37599,-37
SOCO,"1/21/2024 9 p.m. CST",37373,37076,36820,-553
SOCO,"1/21/2024 10 p.m. CST",36657,36256,36177,-480
SOCO,"1/21/2024 11 p.m. CST",35684,35250,35110,-574
SOCO,"1/22/2024 12 a.m. CST",35084,34652,34750,-334
SOCO,"1/22/2024 1 a.m. CST",34910,34561,34708,-202
SOCO,"1/22/2024 2 a.m. CST",35159,34519,34948,-211
SOCO,"1/22/2024 3 a.m. CST",35441,34846,34815,-626
SOCO,"1/22/2024 4 a.m. CST",35687,35435,35129,-558
SOCO,"1/22/2024 5 a.m. CST",37346,37049,36879,-467
SOCO,"1/22/2024 6 a.m. CST",39379,39067,38482,-897
SOCO,"1/22/2024 7 a.m. CST",40895,40625,40588,-307
SOCO,"1/22/2024 8 a.m. CST",40285,40077,40435,150
SOCO,"1/22/2024 9 a.m. CST",38642,38333,39251,609
SOCO,"1/22/2024 10 a.m. CST",36847,36602,37706,859
SOCO,"1/22/2024 11 a.m. CST",35084,34907,35953,869
SOCO,"1/22/2024 12 p.m. CST",34004,33165,34508,504
SOCO,"1/22/2024 1 p.m. CST",32308,31408,32993,685
SOCO,"1/22/2024 2 p.m. CST",30870,29982,31471,601
SOCO,"1/22/2024 3 p.m. CST",29946,29089,30697,751
SOCO,"1/22/2024 4 p.m. CST",29714,28926,30527,813
SOCO,"1/22/2024 5 p.m. CST",29936,29667,31017,1081
SOCO,"1/22/2024 6 p.m. CST",31811,31604,33116,1305
SOCO,"1/22/2024 7 p.m. CST",32326,32153,33595,1269
SOCO,"1/22/2024 8 p.m. CST",32109,31930,33278,1169
SOCO,"1/22/2024 9 p.m. CST",31201,31003,32411,1210
SOCO,"1/22/2024 10 p.m. CST",29674,29525,30985,1311
SOCO,"1/22/2024 11 p.m. CST",27975,27815,29033,1058
SOCO,"1/23/2024 12 a.m. CST",26882,26520,27761,879
SOCO,"1/23/2024 1 a.m. CST",26083,25688,26420,337
SOCO,"1/23/2024 2 a.m. CST",25668,25220,25924,256
SOCO,"1/23/2024 3 a.m. CST",25527,25030,25959,432
SOCO,"1/23/2024 4 a.m. CST",25505,25430,26245,740
SOCO,"1/23/2024 5 a.m. CST",26498,26445,27243,745
SOCO,"1/23/2024 6 a.m. CST",28542,28474,29303,761
SOCO,"1/23/2024 7 a.m. CST",30049,29915,30671,622
SOCO,"1/23/2024 8 a.m. CST",30052,29937,30774,722
SOCO,"1/23/2024 9 a.m. CST",29854,29882,30465,611
SOCO,"1/23/2024 10 a.m. CST",29372,29480,29619,247
SOCO,"1/23/2024 11 a.m. CST",28893,29142,29089,196
SOCO,"1/23/2024 12 p.m. CST",28728,28615,28822,94
SOCO,"1/23/2024 1 p.m. CST",28157,27985,28394,237
SOCO,"1/23/2024 2 p.m. CST",27463,27307,27866,403
SOCO,"1/23/2024 3 p.m. CST",26987,27006,27357,370
SOCO,"1/23/2024 4 p.m. CST",27050,26826,27677,627
SOCO,"1/23/2024 5 p.m. CST",27227,27288,27918,691
SOCO,"1/23/2024 6 p.m. CST",28362,28438,29188,826
SOCO,"1/23/2024 7 p.m. CST",28654,28692,29511,857
SOCO,"1/23/2024 8 p.m. CST",28171,28168,29015,844
SOCO,"1/23/2024 9 p.m. CST",27219,27139,27958,739
SOCO,"1/23/2024 10 p.m. CST",26147,25684,26803,656
SOCO,"1/23/2024 11 p.m. CST",24630,24175,25341,711
SOCO,"1/24/2024 12 a.m. CST",23957,22967,24798,841
SOCO,"1/24/2024 1 a.m. CST",22687,22180,23952,1265
SOCO,"1/24/2024 2 a.m. CST",22190,21740,23569,1379
SOCO,"1/24/2024 3 a.m. CST",22131,21656,23545,1414
SOCO,"1/24/2024 4 a.m. CST",22028,21922,23359,1331
SOCO,"1/24/2024 5 a.m. CST",23077,22939,24333,1256
SOCO,"1/24/2024 6 a.m. CST",24929,24825,25925,996
SOCO,"1/24/2024 7 a.m. CST",26372,26154,27566,1194
SOCO,"1/24/2024 8 a.m. CST",26379,26231,27526,1147
SOCO,"1/24/2024 9 a.m. CST",26369,26217,27474,1105
SOCO,"1/24/2024 10 a.m. CST",26314,26150,27483,1169
SOCO,"1/24/2024 11 a.m. CST",26211,26034,27327,1116
SOCO,"1/24/2024 12 p.m. CST",25923,25783,26935,1012
SOCO,"1/24/2024 1 p.m. CST",26149,25642,27171,1022
SOCO,"1/24/2024 2 p.m. CST",25975,25496,27084,1109
SOCO,"1/24/2024 3 p.m. CST",25636,25132,26809,1173
SOCO,"1/24/2024 4 p.m. CST",25452,25263,26816,1364
SOCO,"1/24/2024 5 p.m. CST",25888,25658,27347,1459
SOCO,"1/24/2024 6 p.m. CST",26738,26482,28247,1509
SOCO,"1/24/2024 7 p.m. CST",26683,26456,28157,1474
SOCO,"1/24/2024 8 p.m. CST",25962,25828,27284,1322
SOCO,"1/24/2024 9 p.m. CST",25040,24892,26605,1565
SOCO,"1/24/2024 10 p.m. CST",23788,23548,25295,1507
SOCO,"1/24/2024 11 p.m. CST",22671,22111,23782,1111
SOCO,"1/25/2024 12 a.m. CST",21513,20903,22632,1119
SOCO,"1/25/2024 1 a.m. CST",21107,20152,22258,1151
SOCO,"1/25/2024 2 a.m. CST",20580,19661,21503,923
SOCO,"1/25/2024 3 a.m. CST",20037,19459,20871,834
SOCO,"1/25/2024 4 a.m. CST",20130,19713,20963,833
SOCO,"1/25/2024 5 a.m. CST",20852,20607,21583,731
SOCO,"1/25/2024 6 a.m. CST",22517,22291,23156,639
SOCO,"1/25/2024 7 a.m. CST",24009,23785,24700,691
SOCO,"1/25/2024 8 a.m. CST",24320,24079,25071,751
SOCO,"1/25/2024 9 a.m. CST",24389,24241,25205,816
SOCO,"1/25/2024 10 a.m. CST",24558,24380,25341,783
SOCO,"1/25/2024 11 a.m. CST",24665,24475,25516,851
SOCO,"1/25/2024 12 p.m. CST",24645,24474,25768,1123
SOCO,"1/25/2024 1 p.m. CST",24680,24478,25968,1288
SOCO,"1/25/2024 2 p.m. CST",24716,24325,25974,1258
SOCO,"1/25/2024 3 p.m. CST",24493,24161,25726,1233
SOCO,"1/25/2024 4 p.m. CST",24394,24226,25419,1025
SOCO,"1/25/2024 5 p.m. CST",24827,24612,26003,1176
SOCO,"1/25/2024 6 p.m. CST",25649,25491,26910,1261
SOCO,"1/25/2024 7 p.m. CST",25589,25450,26697,1108
SOCO,"1/25/2024 8 p.m. CST",25157,24933,26276,1119
SOCO,"1/25/2024 9 p.m. CST",24161,23973,25682,1521
SOCO,"1/25/2024 10 p.m. CST",23109,22785,24630,1521
SOCO,"1/25/2024 11 p.m. CST",22060,21462,23314,1254
SOCO,"1/26/2024 12 a.m. CST",20797,20429,22107,1310
SOCO,"1/26/2024 1 a.m. CST",20503,19600,21528,1025
SOCO,"1/26/2024 2 a.m. CST",19946,19058,21029,1083
SOCO,"1/26/2024 3 a.m. CST",19778,18908,20867,1089
SOCO,"1/26/2024 4 a.m. CST",19982,19141,21139,1157
SOCO,"1/26/2024 5 a.m. CST",20578,19989,21741,1163
SOCO,"1/26/2024 6 a.m. CST",21844,21720,22872,1028
SOCO,"1/26/2024 7 a.m. CST",23211,23108,24523,1312
SOCO,"1/26/2024 8 a.m. CST",23545,23445,24948,1403
SOCO,"1/26/2024 9 a.m. CST",23875,23719,25344,1469
SOCO,"1/26/2024 10 a.m. CST",24002,23900,25267,1265
SOCO,"1/26/2024 11 a.m. CST",24033,23978,25285,1252
SOCO,"1/26/2024 12 p.m. CST",23888,23835,25107,1219
SOCO,"1/26/2024 1 p.m. CST",24216,23766,25633,1417
SOCO,"1/26/2024 2 p.m. CST",24104,23688,25411,1307
SOCO,"1/26/2024 3 p.m. CST",23631,23560,25024,1393
SOCO,"1/26/2024 4 p.m. CST",23567,23428,24822,1255
SOCO,"1/26/2024 5 p.m. CST",23659,23501,24649,990
SOCO,"1/26/2024 6 p.m. CST",24418,24317,25599,1181
SOCO,"1/26/2024 7 p.m. CST",24272,24127,25569,1297
SOCO,"1/26/2024 8 p.m. CST",23773,23628,24934,1161
SOCO,"1/26/2024 9 p.m. CST",23071,22911,24165,1094
SOCO,"1/26/2024 10 p.m. CST",22200,22034,23377,1177
SOCO,"1/26/2024 11 p.m. CST",21236,21075,22234,998
SOCO,"1/27/2024 12 a.m. CST",20190,20071,20934,744
SOCO,"1/27/2024 1 a.m. CST",19827,19320,20293,466
SOCO,"1/27/2024 2 a.m. CST",19750,18849,20253,503
SOCO,"1/27/2024 3 a.m. CST",19461,18579,19963,502
SOCO,"1/27/2024 4 a.m. CST",19489,18598,20078,589
SOCO,"1/27/2024 5 a.m. CST",19719,18815,20364,645
SOCO,"1/27/2024 6 a.m. CST",19961,19398,20775,814
SOCO,"1/27/2024 7 a.m. CST",20292,20115,21037,745
SOCO,"1/27/2024 8 a.m. CST",21225,21034,21879,654
SOCO,"1/27/2024 9 a.m. CST",22202,22004,22878,676
SOCO,"1/27/2024 10 a.m. CST",22926,22847,23782,856
SOCO,"1/27/2024 11 a.m. CST",23325,23135,24091,766
SOCO,"1/27/2024 12 p.m. CST",23372,23187,24181,809
SOCO,"1/27/2024 1 p.m. CST",23340,23136,24071,731
SOCO,"1/27/2024 2 p.m. CST",23144,22930,23813,669
SOCO,"1/27/2024 3 p.m. CST",23025,22834,23644,619
SOCO,"1/27/2024 4 p.m. CST",22966,22816,23614,648
SOCO,"1/27/2024 5 p.m. CST",23138,23016,23577,439
SOCO,"1/27/2024 6 p.m. CST",23698,23601,24144,446
SOCO,"1/27/2024 7 p.m. CST",23688,23546,24204,516
SOCO,"1/27/2024 8 p.m. CST",23259,23186,23883,624
SOCO,"1/27/2024 9 p.m. CST",22710,22537,23446,736
SOCO,"1/27/2024 10 p.m. CST",21903,21763,22557,654
SOCO,"1/27/2024 11 p.m. CST",21071,20913,21609,538
SOCO,"1/28/2024 12 a.m. CST",20343,20181,21001,658
SOCO,"1/28/2024 1 a.m. CST",20341,19624,20706,365
SOCO,"1/28/2024 2 a.m. CST",20254,19377,20553,299
SOCO,"1/28/2024 3 a.m. CST",20295,19398,20615,320
SOCO,"1/28/2024 4 a.m. CST",20501,19597,21241,740
SOCO,"1/28/2024 5 a.m. CST",20592,20093,21535,943
SOCO,"1/28/2024 6 a.m. CST",20989,20839,22108,1119
SOCO,"1/28/2024 7 a.m. CST",22016,21852,22992,976
SOCO,"1/28/2024 8 a.m. CST",23387,23186,24192,805
SOCO,"1/28/2024 9 a.m. CST",24655,24432,25571,916
SOCO,"1/28/2024 10 a.m. CST",25083,24901,26068,985
SOCO,"1/28/2024 11 a.m. CST",25159,24981,26184,1025
SOCO,"1/28/2024 12 p.m. CST",25108,24932,26027,919
SOCO,"1/28/2024 1 p.m. CST",25095,24926,25865,770
SOCO,"1/28/2024 2 p.m. CST",24989,24878,25933,944
SOCO,"1/28/2024 3 p.m. CST",24835,24789,25854,1019
SOCO,"1/28/2024 4 p.m. CST",25363,25238,26250,887
SOCO,"1/28/2024 5 p.m. CST",26219,26125,27206,987
SOCO,"1/28/2024 6 p.m. CST",27695,27640,28761,1066
SOCO,"1/28/2024 7 p.m. CST",28182,28175,29380,1198
SOCO,"1/28/2024 8 p.m. CST",28108,27994,29290,1182
SOCO,"1/28/2024 9 p.m. CST",27440,27305,28310,870
SOCO,"1/28/2024 10 p.m. CST",26514,26368,27274,760
SOCO,"1/28/2024 11 p.m. CST",25272,25076,26133,861
SOCO,"1/29/2024 12 a.m. CST",24750,24184,25449,699
SOCO,"1/29/2024 1 a.m. CST",24727,23763,25335,608
SOCO,"1/29/2024 2 a.m. CST",24655,23708,25364,709
SOCO,"1/29/2024 3 a.m. CST",24920,23957,25650,730
SOCO,"1/29/2024 4 a.m. CST",25606,24666,26399,793
SOCO,"1/29/2024 5 a.m. CST",26678,26248,27618,940
SOCO,"1/29/2024 6 a.m. CST",29043,28833,29888,845
SOCO,"1/29/2024 7 a.m. CST",31109,30984,32216,1107
SOCO,"1/29/2024 8 a.m. CST",31348,31205,32681,1333
SOCO,"1/29/2024 9 a.m. CST",30644,30546,32168,1524
SOCO,"1/29/2024 10 a.m. CST",29623,29450,30986,1363
SOCO,"1/29/2024 11 a.m. CST",28372,28192,29611,1239
SOCO,"1/29/2024 12 p.m. CST",27718,27065,29120,1402
SOCO,"1/29/2024 1 p.m. CST",27029,26148,28579,1550
SOCO,"1/29/2024 2 p.m. CST",26203,25363,28002,1799
SOCO,"1/29/2024 3 p.m. CST",25604,24886,27341,1737
SOCO,"1/29/2024 4 p.m. CST",25447,24996,27215,1768
SOCO,"1/29/2024 5 p.m. CST",25884,25801,27512,1628
SOCO,"1/29/2024 6 p.m. CST",27862,27774,29770,1908
SOCO,"1/29/2024 7 p.m. CST",29030,28932,30552,1522
SOCO,"1/29/2024 8 p.m. CST",29338,29130,30668,1330
SOCO,"1/29/2024 9 p.m. CST",29096,28891,30389,1293
SOCO,"1/29/2024 10 p.m. CST",28249,28067,29351,1102
SOCO,"1/29/2024 11 p.m. CST",28102,27276,29028,926
SOCO,"1/30/2024 12 a.m. CST",27826,26996,28554,728
SOCO,"1/30/2024 1 a.m. CST",27945,26982,28217,272
SOCO,"1/30/2024 2 a.m. CST",28462,27455,28586,124
SOCO,"1/30/2024 3 a.m. CST",28577,28141,28943,366
SOCO,"1/30/2024 4 a.m. CST",29367,29207,29818,451
SOCO,"1/30/2024 5 a.m. CST",31330,31087,31428,98
SOCO,"1/30/2024 6 a.m. CST",34214,33927,34062,-152
SOCO,"1/30/2024 7 a.m. CST",36347,35964,36484,137
SOCO,"1/30/2024 8 a.m. CST",35921,35642,36326,405
SOCO,"1/30/2024 9 a.m. CST",33640,33490,34149,509
SOCO,"1/30/2024 10 a.m. CST",31009,30940,31700,691
SOCO,"1/30/2024 11 a.m. CST",29337,28805,30672,1335
SOCO,"1/30/2024 12 p.m. CST",27912,27302,29083,1171
SOCO,"1/30/2024 1 p.m. CST",27298,26195,28454,1156
SOCO,"1/30/2024 2 p.m. CST",26631,25359,28017,1386
SOCO,"1/30/2024 3 p.m. CST",26056,24765,27516,1460
SOCO,"1/30/2024 4 p.m. CST",25911,24730,27627,1716
SOCO,"1/30/2024 5 p.m. CST",25533,25196,27041,1508
SOCO,"1/30/2024 6 p.m. CST",26885,26696,28454,1569
SOCO,"1/30/2024 7 p.m. CST",27850,27643,29136,1286
SOCO,"1/30/2024 8 p.m. CST",27725,27550,28993,1268
SOCO,"1/30/2024 9 p.m. CST",27086,26925,28132,1046
SOCO,"1/30/2024 10 p.m. CST",26194,25772,27032,838
SOCO,"1/30/2024 11 p.m. CST",25350,24545,25937,587
SOCO,"1/31/2024 12 a.m. CST",24656,23407,24968,312
SOCO,"1/31/2024 1 a.m. CST",24407,23268,24769,362
SOCO,"1/31/2024 2 a.m. CST",24211,23203,24630,419
SOCO,"1/31/2024 3 a.m. CST",24188,23388,24638,450
SOCO,"1/31/2024 4 a.m. CST",24748,24127,25207,459
SOCO,"1/31/2024 5 a.m. CST",25791,25652,25996,205
SOCO,"1/31/2024 6 a.m. CST",28410,28231,29077,667
SOCO,"1/31/2024 7 a.m. CST",30305,30140,31376,1071
SOCO,"1/31/2024 8 a.m. CST",30269,30178,31395,1126
SOCO,"1/31/2024 9 a.m. CST",29208,29081,30556,1348
SOCO,"1/31/2024 10 a.m. CST",28036,27907,29171,1135
SOCO,"1/31/2024 11 a.m. CST",27590,27069,28667,1077
SOCO,"1/31/2024 12 p.m. CST",27054,26213,28113,1059
SOCO,"1/31/2024 1 p.m. CST",26356,25532,27587,1231
SOCO,"1/31/2024 2 p.m. CST",25707,24925,27086,1379
SOCO,"1/31/2024 3 p.m. CST",25189,24613,26507,1318
SOCO,"1/31/2024 4 p.m. CST",24776,24716,26246,1470
SOCO,"1/31/2024 5 p.m. CST",25511,25435,26657,1146
SOCO,"1/31/2024 6 p.m. CST",27300,27171,28209,909
SOCO,"1/31/2024 7 p.m. CST",28526,28373,29370,844
SOCO,"1/31/2024 8 p.m. CST",28892,28719,29616,724
SOCO,"1/31/2024 9 p.m. CST",28658,28505,29295,637
SOCO,"1/31/2024 10 p.m. CST",27959,27794,28366,407
SOCO,"1/31/2024 11 p.m. CST",27244,27112,27482,238
SOCO,"2/1/2024 12 a.m. CST",27321,26828,27687,366
