"BA Code","Timestamp (Hour Ending)","Demand (MWh)","Demand Forecast (MWh)","Net Generation (MWh)","Total Interchange (MWh)"
SOCO,"5/1/2024 12 a.m. CDT",22297,21735,23865,1568
SOCO,"5/1/2024 1 a.m. CDT",21720,20544,23244,1524
SOCO,"5/1/2024 2 a.m. CDT",21106,19725,22582,1476
SOCO,"5/1/2024 3 a.m. CDT",20747,19388,22192,1445
SOCO,"5/1/2024 4 a.m. CDT",20845,19480,22267,1422
SOCO,"5/1/2024 5 a.m. CDT",21243,20104,22743,1500
SOCO,"5/1/2024 6 a.m. CDT",22402,21579,23771,1369
SOCO,"5/1/2024 7 a.m. CDT",23153,22685,25032,1879
SOCO,"5/1/2024 8 a.m. CDT",23904,23416,26195,2291
SOCO,"5/1/2024 9 a.m. CDT",24475,24231,27135,2660
SOCO,"5/1/2024 10 a.m. CDT",25613,25271,28252,2639
SOCO,"5/1/2024 11 a.m. CDT",27090,26655,29494,2404
SOCO,"5/1/2024 12 p.m. CDT",28483,28183,30841,2358
SOCO,"5/1/2024 1 p.m. CDT",29976,29691,32348,2372
SOCO,"5/1/2024 2 p.m. CDT",31229,30948,33441,2212
SOCO,"5/1/2024 3 p.m. CDT",32323,31998,34191,1868
SOCO,"5/1/2024 4 p.m. CDT",33185,32878,35033,1848
SOCO,"5/1/2024 5 p.m. CDT",33617,33355,35632,2015
SOCO,"5/1/2024 6 p.m. CDT",33204,32955,35159,1955
SOCO,"5/1/2024 7 p.m. CDT",32041,31853,33631,1590
SOCO,"5/1/2024 8 p.m. CDT",30624,30445,32495,1871
SOCO,"5/1/2024 9 p.m. CDT",29375,29137,31148,1773
SOCO,"5/1/2024 10 p.m. CDT",27136,26920,28880,1744
SOCO,"5/1/2024 11 p.m. CDT",24662,24461,26048,1386
SOCO,"5/2/2024 12 a.m. CDT",22998,22435,24098,1100
SOCO,"5/2/2024 1 a.m. CDT",22296,21012,22810,514
SOCO,"5/2/2024 2 a.m. CDT",21540,20162,22254,714
SOCO,"5/2/2024 3 a.m. CDT",21008,19624,21487,479
SOCO,"5/2/2024 4 a.m. CDT",20913,19525,21513,600
SOCO,"5/2/2024 5 a.m. CDT",21501,20132,22034,533
SOCO,"5/2/2024 6 a.m. CDT",23027,21629,23368,341
SOCO,"5/2/2024 7 a.m. CDT",23664,22674,24731,1067
SOCO,"5/2/2024 8 a.m. CDT",24282,23432,25901,1619
SOCO,"5/2/2024 9 a.m. CDT",25065,24440,27117,2052
SOCO,"5/2/2024 10 a.m. CDT",26145,25862,28156,2011
SOCO,"5/2/2024 11 a.m. CDT",27852,27563,29646,1794
SOCO,"5/2/2024 12 p.m. CDT",29473,29173,31205,1732
SOCO,"5/2/2024 1 p.m. CDT",31115,30853,32854,1739
SOCO,"5/2/2024 2 p.m. CDT",32343,32098,34248,1905
SOCO,"5/2/2024 3 p.m. CDT",33128,32896,35610,2482
SOCO,"5/2/2024 4 p.m. CDT",33792,33581,36491,2699
SOCO,"5/2/2024 5 p.m. CDT",33947,33780,36723,2776
SOCO,"5/2/2024 6 p.m. CDT",33446,33240,35517,2071
SOCO,"5/2/2024 7 p.m. CDT",32391,32301,34170,1779
SOCO,"5/2/2024 8 p.m. CDT",31435,31320,33099,1664
SOCO,"5/2/2024 9 p.m. CDT",30301,30109,32451,2150
SOCO,"5/2/2024 10 p.m. CDT",28002,27780,29851,1849
SOCO,"5/2/2024 11 p.m. CDT",25677,25479,26995,1318
SOCO,"5/3/2024 12 a.m. CDT",24195,23548,24507,312
SOCO,"5/3/2024 1 a.m. CDT",23444,22128,23555,111
SOCO,"5/3/2024 2 a.m. CDT",22454,21138,22723,269
SOCO,"5/3/2024 3 a.m. CDT",21938,20600,22263,325
SOCO,"5/3/2024 4 a.m. CDT",21896,20570,22231,335
SOCO,"5/3/2024 5 a.m. CDT",22541,21216,22796,255
SOCO,"5/3/2024 6 a.m. CDT",23628,22523,24078,450
SOCO,"5/3/2024 7 a.m. CDT",23984,23586,24783,799
SOCO,"5/3/2024 8 a.m. CDT",24614,24256,25454,840
SOCO,"5/3/2024 9 a.m. CDT",25271,25226,26227,956
SOCO,"5/3/2024 10 a.m. CDT",26609,26570,27511,902
SOCO,"5/3/2024 11 a.m. CDT",28323,28241,29515,1192
SOCO,"5/3/2024 12 p.m. CDT",30080,29935,31157,1077
SOCO,"5/3/2024 1 p.m. CDT",31388,31235,32240,852
SOCO,"5/3/2024 2 p.m. CDT",31988,31882,32914,926
SOCO,"5/3/2024 3 p.m. CDT",32502,32394,33532,1030
SOCO,"5/3/2024 4 p.m. CDT",32617,32490,33728,1111
SOCO,"5/3/2024 5 p.m. CDT",32286,32169,33202,916
SOCO,"5/3/2024 6 p.m. CDT",31291,31150,32376,1085
SOCO,"5/3/2024 7 p.m. CDT",29983,29867,30817,834
SOCO,"5/3/2024 8 p.m. CDT",29278,29154,30415,1137
SOCO,"5/3/2024 9 p.m. CDT",28373,28176,29811,1438
SOCO,"5/3/2024 10 p.m. CDT",26834,26645,27957,1123
SOCO,"5/3/2024 11 p.m. CDT",25058,24902,25686,628
SOCO,"5/4/2024 12 a.m. CDT",23741,23076,24001,260
SOCO,"5/4/2024 1 a.m. CDT",22333,21838,22837,504
SOCO,"5/4/2024 2 a.m. CDT",21263,20791,21687,424
SOCO,"5/4/2024 3 a.m. CDT",20599,20141,21178,579
SOCO,"5/4/2024 4 a.m. CDT",20716,19879,21409,693
SOCO,"5/4/2024 5 a.m. CDT",20641,19804,21217,576
SOCO,"5/4/2024 6 a.m. CDT",20644,20180,21195,551
SOCO,"5/4/2024 7 a.m. CDT",21065,20609,21675,610
SOCO,"5/4/2024 8 a.m. CDT",22086,21594,22846,760
SOCO,"5/4/2024 9 a.m. CDT",23150,22993,24185,1035
SOCO,"5/4/2024 10 a.m. CDT",24528,24337,25666,1138
SOCO,"5/4/2024 11 a.m. CDT",25928,25714,27319,1391
SOCO,"5/4/2024 12 p.m. CDT",26887,26626,28395,1508
SOCO,"5/4/2024 1 p.m. CDT",27544,27203,29222,1678
SOCO,"5/4/2024 2 p.m. CDT",28105,27743,29755,1650
SOCO,"5/4/2024 3 p.m. CDT",28838,28491,30535,1697
SOCO,"5/4/2024 4 p.m. CDT",29372,29075,31432,2060
SOCO,"5/4/2024 5 p.m. CDT",29737,29511,32036,2299
SOCO,"5/4/2024 6 p.m. CDT",29383,29172,31656,2273
SOCO,"5/4/2024 7 p.m. CDT",28563,28371,30717,2154
SOCO,"5/4/2024 8 p.m. CDT",27758,27554,29793,2035
SOCO,"5/4/2024 9 p.m. CDT",26892,26675,28571,1679
SOCO,"5/4/2024 10 p.m. CDT",25324,25150,26863,1539
SOCO,"5/4/2024 11 p.m. CDT",23714,23567,24763,1049
SOCO,"5/5/2024 12 a.m. CDT",22177,22054,23044,867
SOCO,"5/5/2024 1 a.m. CDT",21365,20738,22057,692
SOCO,"5/5/2024 2 a.m. CDT",20440,19784,21212,772
SOCO,"5/5/2024 3 a.m. CDT",19947,19141,20754,807
SOCO,"5/5/2024 4 a.m. CDT",19801,18771,20601,800
SOCO,"5/5/2024 5 a.m. CDT",19708,18649,20443,735
SOCO,"5/5/2024 6 a.m. CDT",19680,18797,20503,823
SOCO,"5/5/2024 7 a.m. CDT",19686,19096,20638,952
SOCO,"5/5/2024 8 a.m. CDT",21127,20525,22071,944
SOCO,"5/5/2024 9 a.m. CDT",22886,22304,23985,1099
SOCO,"5/5/2024 10 a.m. CDT",24466,24166,25851,1385
SOCO,"5/5/2024 11 a.m. CDT",26293,26019,27663,1370
SOCO,"5/5/2024 12 p.m. CDT",28198,27901,29754,1556
SOCO,"5/5/2024 1 p.m. CDT",29857,29547,31148,1291
SOCO,"5/5/2024 2 p.m. CDT",31090,30757,32412,1322
SOCO,"5/5/2024 3 p.m. CDT",31638,31277,33140,1502
SOCO,"5/5/2024 4 p.m. CDT",31661,31302,32916,1255
SOCO,"5/5/2024 5 p.m. CDT",31146,30801,32392,1246
SOCO,"5/5/2024 6 p.m. CDT",30506,30192,31771,1265
SOCO,"5/5/2024 7 p.m. CDT",29542,29282,30771,1229
SOCO,"5/5/2024 8 p.m. CDT",29042,28924,30301,1259
SOCO,"5/5/2024 9 p.m. CDT",28136,27903,29387,1251
SOCO,"5/5/2024 10 p.m. CDT",26420,26214,27696,1276
SOCO,"5/5/2024 11 p.m. CDT",24348,24158,25147,799
SOCO,"5/6/2024 12 a.m. CDT",22952,22333,23888,936
SOCO,"5/6/2024 1 a.m. CDT",21671,21058,22677,1006
SOCO,"5/6/2024 2 a.m. CDT",21041,20270,22177,1136
SOCO,"5/6/2024 3 a.m. CDT",20664,19901,21853,1189
SOCO,"5/6/2024 4 a.m. CDT",20539,19927,21565,1026
SOCO,"5/6/2024 5 a.m. CDT",21334,20717,22255,921
SOCO,"5/6/2024 6 a.m. CDT",22804,22178,23788,984
SOCO,"5/6/2024 7 a.m. CDT",23666,23405,25122,1456
SOCO,"5/6/2024 8 a.m. CDT",24599,24349,26267,1668
SOCO,"5/6/2024 9 a.m. CDT",25739,25484,27330,1591
SOCO,"5/6/2024 10 a.m. CDT",27281,27045,28753,1472
SOCO,"5/6/2024 11 a.m. CDT",29001,28687,30382,1381
SOCO,"5/6/2024 12 p.m. CDT",30820,30544,31947,1127
SOCO,"5/6/2024 1 p.m. CDT",32416,32190,33473,1057
SOCO,"5/6/2024 2 p.m. CDT",33681,33451,34919,1238
SOCO,"5/6/2024 3 p.m. CDT",34517,34255,35987,1470
SOCO,"5/6/2024 4 p.m. CDT",35055,34776,36620,1565
SOCO,"5/6/2024 5 p.m. CDT",35376,35114,36935,1559
SOCO,"5/6/2024 6 p.m. CDT",34935,34648,36469,1534
SOCO,"5/6/2024 7 p.m. CDT",33822,33546,35199,1377
SOCO,"5/6/2024 8 p.m. CDT",32738,32484,34123,1385
SOCO,"5/6/2024 9 p.m. CDT",31457,31170,32553,1096
SOCO,"5/6/2024 10 p.m. CDT",29058,28767,30167,1109
SOCO,"5/6/2024 11 p.m. CDT",26632,26406,27161,529
SOCO,"5/7/2024 12 a.m. CDT",24953,24375,25598,645
SOCO,"5/7/2024 1 a.m. CDT",23851,22864,24501,650
SOCO,"5/7/2024 2 a.m. CDT",22795,21866,23610,815
SOCO,"5/7/2024 3 a.m. CDT",22079,21165,22924,845
SOCO,"5/7/2024 4 a.m. CDT",22005,21099,22917,912
SOCO,"5/7/2024 5 a.m. CDT",22545,21837,23340,795
SOCO,"5/7/2024 6 a.m. CDT",23663,23205,24396,733
SOCO,"5/7/2024 7 a.m. CDT",24565,24306,25737,1172
SOCO,"5/7/2024 8 a.m. CDT",25523,25263,26825,1302
SOCO,"5/7/2024 9 a.m. CDT",26741,26418,27985,1244
SOCO,"5/7/2024 10 a.m. CDT",28222,27908,29808,1586
SOCO,"5/7/2024 11 a.m. CDT",29848,29515,31426,1578
SOCO,"5/7/2024 12 p.m. CDT",31327,30991,32786,1459
SOCO,"5/7/2024 1 p.m. CDT",32802,32448,34112,1310
SOCO,"5/7/2024 2 p.m. CDT",33836,33509,35237,1401
SOCO,"5/7/2024 3 p.m. CDT",34651,34375,36288,1637
SOCO,"5/7/2024 4 p.m. CDT",35211,34938,36987,1776
SOCO,"5/7/2024 5 p.m. CDT",35176,34764,36698,1522
SOCO,"5/7/2024 6 p.m. CDT",34640,34385,36015,1375
SOCO,"5/7/2024 7 p.m. CDT",33852,33658,35214,1362
SOCO,"5/7/2024 8 p.m. CDT",33152,33017,34346,1194
SOCO,"5/7/2024 9 p.m. CDT",32186,31991,33292,1106
SOCO,"5/7/2024 10 p.m. CDT",29970,29731,30562,592
SOCO,"5/7/2024 11 p.m. CDT",27617,27460,28089,472
SOCO,"5/8/2024 12 a.m. CDT",25679,25461,26090,411
SOCO,"5/8/2024 1 a.m. CDT",24745,24034,25172,427
SOCO,"5/8/2024 2 a.m. CDT",24188,23121,24731,543
SOCO,"5/8/2024 3 a.m. CDT",23499,22435,23961,462
SOCO,"5/8/2024 4 a.m. CDT",23270,22231,23837,567
SOCO,"5/8/2024 5 a.m. CDT",23831,22735,24467,636
SOCO,"5/8/2024 6 a.m. CDT",24863,24125,25578,715
SOCO,"5/8/2024 7 a.m. CDT",25788,25180,27204,1416
SOCO,"5/8/2024 8 a.m. CDT",26617,25974,28226,1609
SOCO,"5/8/2024 9 a.m. CDT",27768,27134,29444,1676
SOCO,"5/8/2024 10 a.m. CDT",29213,28554,30844,1631
SOCO,"5/8/2024 11 a.m. CDT",30209,29947,31768,1559
SOCO,"5/8/2024 12 p.m. CDT",31422,31181,33074,1652
SOCO,"5/8/2024 1 p.m. CDT",32669,32414,34569,1900
SOCO,"5/8/2024 2 p.m. CDT",33990,33737,36305,2315
SOCO,"5/8/2024 3 p.m. CDT",35347,35088,37533,2186
SOCO,"5/8/2024 4 p.m. CDT",36337,36033,38541,2204
SOCO,"5/8/2024 5 p.m. CDT",36872,36536,38882,2010
SOCO,"5/8/2024 6 p.m. CDT",36564,36172,38462,1898
SOCO,"5/8/2024 7 p.m. CDT",35422,35057,36928,1506
SOCO,"5/8/2024 8 p.m. CDT",34523,34360,36085,1562
SOCO,"5/8/2024 9 p.m. CDT",33433,33327,35042,1609
SOCO,"5/8/2024 10 p.m. CDT",31160,30909,32280,1120
SOCO,"5/8/2024 11 p.m. CDT",29025,28436,29121,96
SOCO,"5/9/2024 12 a.m. CDT",27256,26341,26907,-349
SOCO,"5/9/2024 1 a.m. CDT",26128,24866,25919,-209
SOCO,"5/9/2024 2 a.m. CDT",25194,23968,25310,116
SOCO,"5/9/2024 3 a.m. CDT",24525,23338,24801,276
SOCO,"5/9/2024 4 a.m. CDT",24421,23228,24704,283
SOCO,"5/9/2024 5 a.m. CDT",24913,23707,25098,185
SOCO,"5/9/2024 6 a.m. CDT",25866,25046,25805,-61
SOCO,"5/9/2024 7 a.m. CDT",26273,26091,26724,451
SOCO,"5/9/2024 8 a.m. CDT",26847,26727,27279,432
SOCO,"5/9/2024 9 a.m. CDT",27363,27182,28082,719
SOCO,"5/9/2024 10 a.m. CDT",28104,27929,29050,946
SOCO,"5/9/2024 11 a.m. CDT",28413,28222,29309,896
SOCO,"5/9/2024 12 p.m. CDT",28810,28529,30342,1532
SOCO,"5/9/2024 1 p.m. CDT",29324,28971,31197,1873
SOCO,"5/9/2024 2 p.m. CDT",29748,29372,31780,2032
SOCO,"5/9/2024 3 p.m. CDT",30007,29652,32151,2144
SOCO,"5/9/2024 4 p.m. CDT",30319,29982,32520,2201
SOCO,"5/9/2024 5 p.m. CDT",30709,30267,32788,2079
SOCO,"5/9/2024 6 p.m. CDT",30651,30209,32753,2102
SOCO,"5/9/2024 7 p.m. CDT",30146,29736,32040,1894
SOCO,"5/9/2024 8 p.m. CDT",29709,29260,31422,1713
SOCO,"5/9/2024 9 p.m. CDT",28858,28437,30649,1791
SOCO,"5/9/2024 10 p.m. CDT",27073,26663,29039,1966
SOCO,"5/9/2024 11 p.m. CDT",25183,24744,26448,1265
SOCO,"5/10/2024 12 a.m. CDT",23796,23206,24599,803
SOCO,"5/10/2024 1 a.m. CDT",22886,22018,23434,548
SOCO,"5/10/2024 2 a.m. CDT",22216,21180,22859,643
SOCO,"5/10/2024 3 a.m. CDT",21707,20701,22375,668
SOCO,"5/10/2024 4 a.m. CDT",21419,20411,22062,643
SOCO,"5/10/2024 5 a.m. CDT",21709,20724,22357,648
SOCO,"5/10/2024 6 a.m. CDT",22550,22001,23219,669
SOCO,"5/10/2024 7 a.m. CDT",23248,23044,24315,1067
SOCO,"5/10/2024 8 a.m. CDT",23994,23843,25153,1159
SOCO,"5/10/2024 9 a.m. CDT",24714,24605,25947,1233
SOCO,"5/10/2024 10 a.m. CDT",25519,25364,26620,1101
SOCO,"5/10/2024 11 a.m. CDT",26456,26325,27524,1068
SOCO,"5/10/2024 12 p.m. CDT",27530,27345,28758,1228
SOCO,"5/10/2024 1 p.m. CDT",28647,28523,30283,1636
SOCO,"5/10/2024 2 p.m. CDT",29728,29591,31544,1816
SOCO,"5/10/2024 3 p.m. CDT",30554,30412,32071,1517
SOCO,"5/10/2024 4 p.m. CDT",31139,30914,32874,1735
SOCO,"5/10/2024 5 p.m. CDT",31172,30973,32835,1663
SOCO,"5/10/2024 6 p.m. CDT",30387,30197,31851,1464
SOCO,"5/10/2024 7 p.m. CDT",29020,28858,30370,1350
SOCO,"5/10/2024 8 p.m. CDT",27675,27522,29278,1603
SOCO,"5/10/2024 9 p.m. CDT",26873,26634,28525,1652
SOCO,"5/10/2024 10 p.m. CDT",25119,24915,26804,1685
SOCO,"5/10/2024 11 p.m. CDT",23332,23153,23969,637
SOCO,"5/11/2024 12 a.m. CDT",21599,21416,22314,715
SOCO,"5/11/2024 1 a.m. CDT",20481,19972,21514,1033
SOCO,"5/11/2024 2 a.m. CDT",19566,18984,20717,1151
SOCO,"5/11/2024 3 a.m. CDT",18930,18347,20118,1188
SOCO,"5/11/2024 4 a.m. CDT",18604,18000,19831,1227
SOCO,"5/11/2024 5 a.m. CDT",18592,18011,19853,1261
SOCO,"5/11/2024 6 a.m. CDT",18767,18182,20098,1331
SOCO,"5/11/2024 7 a.m. CDT",19195,18775,20861,1666
SOCO,"5/11/2024 8 a.m. CDT",20298,19814,22166,1868
SOCO,"5/11/2024 9 a.m. CDT",21280,20766,23116,1836
SOCO,"5/11/2024 10 a.m. CDT",22231,21654,24013,1782
SOCO,"5/11/2024 11 a.m. CDT",23129,22486,24667,1538
SOCO,"5/11/2024 12 p.m. CDT",23828,23186,25327,1499
SOCO,"5/11/2024 1 p.m. CDT",24272,23910,25756,1484
SOCO,"5/11/2024 2 p.m. CDT",25113,24711,26560,1447
SOCO,"5/11/2024 3 p.m. CDT",25950,25554,27455,1505
SOCO,"5/11/2024 4 p.m. CDT",26803,26393,28380,1577
SOCO,"5/11/2024 5 p.m. CDT",27228,26884,28808,1580
SOCO,"5/11/2024 6 p.m. CDT",27031,26719,28823,1792
SOCO,"5/11/2024 7 p.m. CDT",26050,25785,27793,1743
SOCO,"5/11/2024 8 p.m. CDT",24951,24719,26763,1812
SOCO,"5/11/2024 9 p.m. CDT",24240,24037,25765,1525
SOCO,"5/11/2024 10 p.m. CDT",23009,22820,24565,1556
SOCO,"5/11/2024 11 p.m. CDT",21485,21248,22647,1162
SOCO,"5/12/2024 12 a.m. CDT",20070,19860,20978,908
SOCO,"5/12/2024 1 a.m. CDT",18985,18768,20057,1072
SOCO,"5/12/2024 2 a.m. CDT",18630,18057,19628,998
SOCO,"5/12/2024 3 a.m. CDT",18106,17562,19293,1187
SOCO,"5/12/2024 4 a.m. CDT",18264,17358,19330,1066
SOCO,"5/12/2024 5 a.m. CDT",18236,17322,19316,1080
SOCO,"5/12/2024 6 a.m. CDT",18376,17493,19447,1071
SOCO,"5/12/2024 7 a.m. CDT",18597,18051,19981,1384
SOCO,"5/12/2024 8 a.m. CDT",19663,19251,21241,1578
SOCO,"5/12/2024 9 a.m. CDT",20672,20237,22198,1526
SOCO,"5/12/2024 10 a.m. CDT",21338,21114,22839,1501
SOCO,"5/12/2024 11 a.m. CDT",21793,21639,23213,1420
SOCO,"5/12/2024 12 p.m. CDT",22704,22453,23941,1237
SOCO,"5/12/2024 1 p.m. CDT",23563,23306,24775,1212
SOCO,"5/12/2024 2 p.m. CDT",24501,24246,25616,1115
SOCO,"5/12/2024 3 p.m. CDT",25563,25273,26823,1260
SOCO,"5/12/2024 4 p.m. CDT",26499,26229,27917,1418
SOCO,"5/12/2024 5 p.m. CDT",26979,26777,28601,1622
SOCO,"5/12/2024 6 p.m. CDT",26767,26566,28541,1774
SOCO,"5/12/2024 7 p.m. CDT",26083,25890,27855,1772
SOCO,"5/12/2024 8 p.m. CDT",25776,25587,27446,1670
SOCO,"5/12/2024 9 p.m. CDT",25377,25196,26620,1243
SOCO,"5/12/2024 10 p.m. CDT",23921,23721,25094,1173
SOCO,"5/12/2024 11 p.m. CDT",22154,21945,23044,890
SOCO,"5/13/2024 12 a.m. CDT",20981,20383,22086,1105
SOCO,"5/13/2024 1 a.m. CDT",20226,19271,21163,937
SOCO,"5/13/2024 2 a.m. CDT",19600,18669,20573,973
SOCO,"5/13/2024 3 a.m. CDT",19404,18469,20457,1053
SOCO,"5/13/2024 4 a.m. CDT",19453,18628,20552,1099
SOCO,"5/13/2024 5 a.m. CDT",19987,19432,20945,958
SOCO,"5/13/2024 6 a.m. CDT",21292,20993,22211,919
SOCO,"5/13/2024 7 a.m. CDT",22452,22289,23327,875
SOCO,"5/13/2024 8 a.m. CDT",23225,23281,24311,1086
SOCO,"5/13/2024 9 a.m. CDT",23888,23978,25103,1215
SOCO,"5/13/2024 10 a.m. CDT",24072,24162,25326,1254
SOCO,"5/13/2024 11 a.m. CDT",24317,24221,25499,1182
SOCO,"5/13/2024 12 p.m. CDT",24514,24357,25868,1354
SOCO,"5/13/2024 1 p.m. CDT",24558,24415,26087,1529
SOCO,"5/13/2024 2 p.m. CDT",24452,24302,26169,1717
SOCO,"5/13/2024 3 p.m. CDT",24345,24164,26183,1838
SOCO,"5/13/2024 4 p.m. CDT",24407,24197,26647,2240
SOCO,"5/13/2024 5 p.m. CDT",24651,24405,27305,2654
SOCO,"5/13/2024 6 p.m. CDT",24720,24478,27104,2384
SOCO,"5/13/2024 7 p.m. CDT",24797,24553,26954,2157
SOCO,"5/13/2024 8 p.m. CDT",25068,24852,27230,2162
SOCO,"5/13/2024 9 p.m. CDT",24840,24641,26889,2049
SOCO,"5/13/2024 10 p.m. CDT",23618,23404,25463,1845
SOCO,"5/13/2024 11 p.m. CDT",22088,21845,23368,1280
SOCO,"5/14/2024 12 a.m. CDT",21161,20585,22337,1176
SOCO,"5/14/2024 1 a.m. CDT",20320,19719,21242,922
SOCO,"5/14/2024 2 a.m. CDT",20084,19250,21004,920
SOCO,"5/14/2024 3 a.m. CDT",19915,19066,20758,843
SOCO,"5/14/2024 4 a.m. CDT",19714,19147,20645,931
SOCO,"5/14/2024 5 a.m. CDT",20381,19807,21317,936
SOCO,"5/14/2024 6 a.m. CDT",21678,21509,22695,1017
SOCO,"5/14/2024 7 a.m. CDT",22850,22723,24404,1554
SOCO,"5/14/2024 8 a.m. CDT",23560,23401,25207,1647
SOCO,"5/14/2024 9 a.m. CDT",24337,24153,25910,1573
SOCO,"5/14/2024 10 a.m. CDT",25017,24768,26695,1678
SOCO,"5/14/2024 11 a.m. CDT",25582,25339,27395,1813
SOCO,"5/14/2024 12 p.m. CDT",26216,25960,28028,1812
SOCO,"5/14/2024 1 p.m. CDT",27007,26746,28829,1822
SOCO,"5/14/2024 2 p.m. CDT",27772,27492,30060,2288
SOCO,"5/14/2024 3 p.m. CDT",28697,28408,31340,2643
SOCO,"5/14/2024 4 p.m. CDT",29300,28969,31861,2561
SOCO,"5/14/2024 5 p.m. CDT",29763,29433,32225,2462
SOCO,"5/14/2024 6 p.m. CDT",29876,29617,32235,2359
SOCO,"5/14/2024 7 p.m. CDT",29649,29353,31966,2317
SOCO,"5/14/2024 8 p.m. CDT",29281,28982,31477,2196
SOCO,"5/14/2024 9 p.m. CDT",28661,28418,30570,1909
SOCO,"5/14/2024 10 p.m. CDT",26901,26684,28546,1645
SOCO,"5/14/2024 11 p.m. CDT",24790,24618,25359,569
SOCO,"5/15/2024 12 a.m. CDT",23294,22881,23951,657
SOCO,"5/15/2024 1 a.m. CDT",22199,21633,23159,960
SOCO,"5/15/2024 2 a.m. CDT",21713,20797,22575,862
SOCO,"5/15/2024 3 a.m. CDT",21337,20414,22255,918
SOCO,"5/15/2024 4 a.m. CDT",21206,20262,21906,700
SOCO,"5/15/2024 5 a.m. CDT",21796,20874,22646,850
SOCO,"5/15/2024 6 a.m. CDT",23171,22226,23853,682
SOCO,"5/15/2024 7 a.m. CDT",24160,23292,25270,1110
SOCO,"5/15/2024 8 a.m. CDT",24861,24248,26078,1217
SOCO,"5/15/2024 9 a.m. CDT",25993,25685,27311,1318
SOCO,"5/15/2024 10 a.m. CDT",27089,26695,28582,1493
SOCO,"5/15/2024 11 a.m. CDT",28205,27880,29766,1561
SOCO,"5/15/2024 12 p.m. CDT",29271,28923,30749,1478
SOCO,"5/15/2024 1 p.m. CDT",30320,29939,31792,1472
SOCO,"5/15/2024 2 p.m. CDT",31138,30754,32901,1763
SOCO,"5/15/2024 3 p.m. CDT",31788,31440,33695,1907
SOCO,"5/15/2024 4 p.m. CDT",32434,32022,34418,1984
SOCO,"5/15/2024 5 p.m. CDT",32640,32365,34675,2035
SOCO,"5/15/2024 6 p.m. CDT",32313,31974,34121,1808
SOCO,"5/15/2024 7 p.m. CDT",31419,31106,32975,1556
SOCO,"5/15/2024 8 p.m. CDT",30310,30031,32174,1864
SOCO,"5/15/2024 9 p.m. CDT",29383,29045,31344,1961
SOCO,"5/15/2024 10 p.m. CDT",27369,26985,29251,1882
SOCO,"5/15/2024 11 p.m. CDT",25070,24700,26460,1390
SOCO,"5/16/2024 12 a.m. CDT",23454,22781,24454,1000
SOCO,"5/16/2024 1 a.m. CDT",22607,21368,23604,997
SOCO,"5/16/2024 2 a.m. CDT",21727,20534,22767,1040
SOCO,"5/16/2024 3 a.m. CDT",21173,19961,22333,1160
SOCO,"5/16/2024 4 a.m. CDT",21080,19896,22192,1112
SOCO,"5/16/2024 5 a.m. CDT",21416,20484,22447,1031
SOCO,"5/16/2024 6 a.m. CDT",22601,21775,23684,1083
SOCO,"5/16/2024 7 a.m. CDT",23427,22812,24861,1434
SOCO,"5/16/2024 8 a.m. CDT",24530,23880,26059,1529
SOCO,"5/16/2024 9 a.m. CDT",25627,24964,27294,1667
SOCO,"5/16/2024 10 a.m. CDT",27053,26350,29124,2071
SOCO,"5/16/2024 11 a.m. CDT",28379,27831,30381,2002
SOCO,"5/16/2024 12 p.m. CDT",29717,29358,31831,2114
SOCO,"5/16/2024 1 p.m. CDT",31196,30898,33207,2011
SOCO,"5/16/2024 2 p.m. CDT",32657,32346,35018,2361
SOCO,"5/16/2024 3 p.m. CDT",33720,33362,36053,2333
SOCO,"5/16/2024 4 p.m. CDT",34704,34312,37453,2749
SOCO,"5/16/2024 5 p.m. CDT",34930,34606,37572,2642
SOCO,"5/16/2024 6 p.m. CDT",34332,34088,37006,2674
SOCO,"5/16/2024 7 p.m. CDT",33217,33031,35875,2658
SOCO,"5/16/2024 8 p.m. CDT",31749,31572,34152,2403
SOCO,"5/16/2024 9 p.m. CDT",30544,30400,33031,2487
SOCO,"5/16/2024 10 p.m. CDT",28450,28059,30518,2068
SOCO,"5/16/2024 11 p.m. CDT",26240,25659,27085,845
SOCO,"5/17/2024 12 a.m. CDT",24607,23777,25435,828
SOCO,"5/17/2024 1 a.m. CDT",23710,22295,24980,1270
SOCO,"5/17/2024 2 a.m. CDT",22631,21247,23789,1158
SOCO,"5/17/2024 3 a.m. CDT",22086,20700,23366,1280
SOCO,"5/17/2024 4 a.m. CDT",21927,20527,23269,1342
SOCO,"5/17/2024 5 a.m. CDT",22412,21016,23616,1204
SOCO,"5/17/2024 6 a.m. CDT",23424,22388,24547,1123
SOCO,"5/17/2024 7 a.m. CDT",24204,23431,25566,1362
SOCO,"5/17/2024 8 a.m. CDT",24981,24160,26291,1310
SOCO,"5/17/2024 9 a.m. CDT",25333,24891,26826,1493
SOCO,"5/17/2024 10 a.m. CDT",25994,25533,27848,1854
SOCO,"5/17/2024 11 a.m. CDT",26382,26028,28081,1699
SOCO,"5/17/2024 12 p.m. CDT",26636,26381,28412,1776
SOCO,"5/17/2024 1 p.m. CDT",26797,26533,28795,1998
SOCO,"5/17/2024 2 p.m. CDT",26766,26486,28872,2106
SOCO,"5/17/2024 3 p.m. CDT",26713,26584,29096,2383
SOCO,"5/17/2024 4 p.m. CDT",26657,26582,29062,2405
SOCO,"5/17/2024 5 p.m. CDT",26703,26663,29505,2802
SOCO,"5/17/2024 6 p.m. CDT",26489,26470,29163,2674
SOCO,"5/17/2024 7 p.m. CDT",26075,26082,29000,2925
SOCO,"5/17/2024 8 p.m. CDT",25952,25923,28816,2864
SOCO,"5/17/2024 9 p.m. CDT",25717,25614,28189,2472
SOCO,"5/17/2024 10 p.m. CDT",24763,24711,26505,1742
SOCO,"5/17/2024 11 p.m. CDT",23553,23607,25187,1634
SOCO,"5/18/2024 12 a.m. CDT",22393,22440,23535,1142
SOCO,"5/18/2024 1 a.m. CDT",21759,21358,22633,874
SOCO,"5/18/2024 2 a.m. CDT",21195,20643,22220,1025
SOCO,"5/18/2024 3 a.m. CDT",20716,20183,21670,954
SOCO,"5/18/2024 4 a.m. CDT",20491,19926,21684,1193
SOCO,"5/18/2024 5 a.m. CDT",20561,19872,21699,1138
SOCO,"5/18/2024 6 a.m. CDT",20840,20089,22232,1392
SOCO,"5/18/2024 7 a.m. CDT",21241,20512,22619,1378
SOCO,"5/18/2024 8 a.m. CDT",22371,21640,23886,1515
SOCO,"5/18/2024 9 a.m. CDT",23250,22896,24841,1591
SOCO,"5/18/2024 10 a.m. CDT",24255,23896,25684,1429
SOCO,"5/18/2024 11 a.m. CDT",25065,24786,26581,1516
SOCO,"5/18/2024 12 p.m. CDT",25722,25420,27339,1617
SOCO,"5/18/2024 1 p.m. CDT",26355,26004,28332,1977
SOCO,"5/18/2024 2 p.m. CDT",26906,26640,29282,2376
SOCO,"5/18/2024 3 p.m. CDT",27521,27202,30715,3194
SOCO,"5/18/2024 4 p.m. CDT",27778,27460,31147,3369
SOCO,"5/18/2024 5 p.m. CDT",27583,27230,30876,3293
SOCO,"5/18/2024 6 p.m. CDT",27310,26955,30213,2903
SOCO,"5/18/2024 7 p.m. CDT",26853,26585,29731,2878
SOCO,"5/18/2024 8 p.m. CDT",26275,26011,28865,2590
SOCO,"5/18/2024 9 p.m. CDT",25663,25454,27984,2321
SOCO,"5/18/2024 10 p.m. CDT",24513,24208,26409,1896
SOCO,"5/18/2024 11 p.m. CDT",23091,22840,24824,1733
SOCO,"5/19/2024 12 a.m. CDT",21989,21419,23341,1352
SOCO,"5/19/2024 1 a.m. CDT",20863,20302,21872,1009
SOCO,"5/19/2024 2 a.m. CDT",19966,19401,21335,1369
SOCO,"5/19/2024 3 a.m. CDT",19441,18891,20967,1526
SOCO,"5/19/2024 4 a.m. CDT",19135,18599,20619,1484
SOCO,"5/19/2024 5 a.m. CDT",19110,18585,20595,1485
SOCO,"5/19/2024 6 a.m. CDT",19238,18693,20807,1569
SOCO,"5/19/2024 7 a.m. CDT",19637,19066,21344,1707
SOCO,"5/19/2024 8 a.m. CDT",20957,20358,22780,1823
SOCO,"5/19/2024 9 a.m. CDT",22484,21849,24453,1969
SOCO,"5/19/2024 10 a.m. CDT",23873,23185,25588,1715
SOCO,"5/19/2024 11 a.m. CDT",24825,24435,26816,1991
SOCO,"5/19/2024 12 p.m. CDT",26212,25778,28618,2406
SOCO,"5/19/2024 1 p.m. CDT",27575,27199,29777,2202
SOCO,"5/19/2024 2 p.m. CDT",28765,28471,31184,2419
SOCO,"5/19/2024 3 p.m. CDT",29835,29467,32792,2957
SOCO,"5/19/2024 4 p.m. CDT",30725,30424,33701,2976
SOCO,"5/19/2024 5 p.m. CDT",31235,30936,33952,2717
SOCO,"5/19/2024 6 p.m. CDT",31249,30945,33863,2614
SOCO,"5/19/2024 7 p.m. CDT",30578,30296,33257,2679
SOCO,"5/19/2024 8 p.m. CDT",29419,29211,31989,2570
SOCO,"5/19/2024 9 p.m. CDT",28624,28386,31069,2445
SOCO,"5/19/2024 10 p.m. CDT",26754,26465,28935,2181
SOCO,"5/19/2024 11 p.m. CDT",24629,24377,26089,1460
SOCO,"5/20/2024 12 a.m. CDT",23078,22507,24326,1248
SOCO,"5/20/2024 1 a.m. CDT",21625,21040,22734,1109
SOCO,"5/20/2024 2 a.m. CDT",20665,20115,22105,1440
SOCO,"5/20/2024 3 a.m. CDT",20043,19509,21351,1308
SOCO,"5/20/2024 4 a.m. CDT",19952,19441,21260,1308
SOCO,"5/20/2024 5 a.m. CDT",20535,20044,21844,1309
SOCO,"5/20/2024 6 a.m. CDT",21929,21426,23305,1376
SOCO,"5/20/2024 7 a.m. CDT",23246,22713,25049,1803
SOCO,"5/20/2024 8 a.m. CDT",24469,23865,26451,1982
SOCO,"5/20/2024 9 a.m. CDT",25712,25095,27907,2195
SOCO,"5/20/2024 10 a.m. CDT",27013,26422,29472,2459
SOCO,"5/20/2024 11 a.m. CDT",28210,27854,30949,2739
SOCO,"5/20/2024 12 p.m. CDT",29731,29403,32684,2953
SOCO,"5/20/2024 1 p.m. CDT",31220,30912,34177,2957
SOCO,"5/20/2024 2 p.m. CDT",32749,32411,36001,3252
SOCO,"5/20/2024 3 p.m. CDT",33921,33644,37577,3656
SOCO,"5/20/2024 4 p.m. CDT",34663,34346,38259,3596
SOCO,"5/20/2024 5 p.m. CDT",35074,34779,38521,3447
SOCO,"5/20/2024 6 p.m. CDT",34523,34324,37870,3347
SOCO,"5/20/2024 7 p.m. CDT",33502,33329,36637,3135
SOCO,"5/20/2024 8 p.m. CDT",31993,31797,35496,3503
SOCO,"5/20/2024 9 p.m. CDT",30674,30447,33990,3316
SOCO,"5/20/2024 10 p.m. CDT",28446,28159,30971,2525
SOCO,"5/20/2024 11 p.m. CDT",25915,25698,27647,1732
SOCO,"5/21/2024 12 a.m. CDT",23999,23584,25604,1605
SOCO,"5/21/2024 1 a.m. CDT",23229,22016,24628,1399
SOCO,"5/21/2024 2 a.m. CDT",22289,21012,23689,1400
SOCO,"5/21/2024 3 a.m. CDT",21652,20371,23019,1367
SOCO,"5/21/2024 4 a.m. CDT",21530,20239,22923,1393
SOCO,"5/21/2024 5 a.m. CDT",22043,20766,23333,1290
SOCO,"5/21/2024 6 a.m. CDT",22927,21991,24317,1390
SOCO,"5/21/2024 7 a.m. CDT",24011,23068,25707,1696
SOCO,"5/21/2024 8 a.m. CDT",25137,24244,27072,1935
SOCO,"5/21/2024 9 a.m. CDT",26380,25682,28560,2180
SOCO,"5/21/2024 10 a.m. CDT",27664,27301,29857,2193
SOCO,"5/21/2024 11 a.m. CDT",29514,29110,31419,1905
SOCO,"5/21/2024 12 p.m. CDT",31162,30758,33075,1913
SOCO,"5/21/2024 1 p.m. CDT",32643,32213,34636,1993
SOCO,"5/21/2024 2 p.m. CDT",34114,33685,36477,2363
SOCO,"5/21/2024 3 p.m. CDT",35215,34902,37916,2701
SOCO,"5/21/2024 4 p.m. CDT",36073,35811,38784,2711
SOCO,"5/21/2024 5 p.m. CDT",36121,35887,38828,2707
SOCO,"5/21/2024 6 p.m. CDT",35615,35357,38493,2878
SOCO,"5/21/2024 7 p.m. CDT",34430,34127,36912,2482
SOCO,"5/21/2024 8 p.m. CDT",32683,32397,35246,2563
SOCO,"5/21/2024 9 p.m. CDT",31374,31048,33631,2257
SOCO,"5/21/2024 10 p.m. CDT",29123,28704,31023,1900
SOCO,"5/21/2024 11 p.m. CDT",26623,26217,28144,1521
SOCO,"5/22/2024 12 a.m. CDT",24664,24056,26080,1416
SOCO,"5/22/2024 1 a.m. CDT",23545,22490,24733,1188
SOCO,"5/22/2024 2 a.m. CDT",22510,21460,23857,1347
SOCO,"5/22/2024 3 a.m. CDT",21833,20753,23191,1358
SOCO,"5/22/2024 4 a.m. CDT",21581,20536,23102,1521
SOCO,"5/22/2024 5 a.m. CDT",22094,21032,23627,1533
SOCO,"5/22/2024 6 a.m. CDT",22684,22105,24372,1688
SOCO,"5/22/2024 7 a.m. CDT",23808,23202,25792,1984
SOCO,"5/22/2024 8 a.m. CDT",25069,24434,26999,1930
SOCO,"5/22/2024 9 a.m. CDT",26594,25957,29005,2411
SOCO,"5/22/2024 10 a.m. CDT",28152,27849,30538,2386
SOCO,"5/22/2024 11 a.m. CDT",30155,29807,32379,2224
SOCO,"5/22/2024 12 p.m. CDT",31975,31609,34231,2256
SOCO,"5/22/2024 1 p.m. CDT",33790,33400,36498,2708
SOCO,"5/22/2024 2 p.m. CDT",35141,34665,37968,2827
SOCO,"5/22/2024 3 p.m. CDT",36248,35765,38944,2696
SOCO,"5/22/2024 4 p.m. CDT",36977,36609,39804,2827
SOCO,"5/22/2024 5 p.m. CDT",36992,36674,40177,3185
SOCO,"5/22/2024 6 p.m. CDT",36009,35720,39006,2997
SOCO,"5/22/2024 7 p.m. CDT",34654,34420,37463,2809
SOCO,"5/22/2024 8 p.m. CDT",33373,33038,36203,2830
SOCO,"5/22/2024 9 p.m. CDT",32136,31835,34976,2840
SOCO,"5/22/2024 10 p.m. CDT",30014,29469,32439,2425
SOCO,"5/22/2024 11 p.m. CDT",27714,27115,28946,1232
SOCO,"5/23/2024 12 a.m. CDT",25817,24942,26915,1098
SOCO,"5/23/2024 1 a.m. CDT",24759,23406,25451,692
SOCO,"5/23/2024 2 a.m. CDT",23750,22395,24491,741
SOCO,"5/23/2024 3 a.m. CDT",22976,21613,23750,774
SOCO,"5/23/2024 4 a.m. CDT",22732,21533,23554,822
SOCO,"5/23/2024 5 a.m. CDT",22920,21988,23708,788
SOCO,"5/23/2024 6 a.m. CDT",23918,23087,24703,785
SOCO,"5/23/2024 7 a.m. CDT",24792,24215,26144,1352
SOCO,"5/23/2024 8 a.m. CDT",25960,25428,27383,1423
SOCO,"5/23/2024 9 a.m. CDT",27081,26856,28794,1713
SOCO,"5/23/2024 10 a.m. CDT",28783,28559,30516,1733
SOCO,"5/23/2024 11 a.m. CDT",30619,30342,32237,1618
SOCO,"5/23/2024 12 p.m. CDT",32733,32414,34409,1676
SOCO,"5/23/2024 1 p.m. CDT",34546,34182,36442,1896
SOCO,"5/23/2024 2 p.m. CDT",35689,35337,37795,2106
SOCO,"5/23/2024 3 p.m. CDT",36644,36279,38582,1938
SOCO,"5/23/2024 4 p.m. CDT",37017,36694,38674,1657
SOCO,"5/23/2024 5 p.m. CDT",36723,36382,38615,1892
SOCO,"5/23/2024 6 p.m. CDT",36055,35728,37888,1833
SOCO,"5/23/2024 7 p.m. CDT",34794,34477,36678,1884
SOCO,"5/23/2024 8 p.m. CDT",33356,33061,35107,1751
SOCO,"5/23/2024 9 p.m. CDT",32356,32005,33925,1569
SOCO,"5/23/2024 10 p.m. CDT",30291,29893,31671,1380
SOCO,"5/23/2024 11 p.m. CDT",28188,27646,28711,523
SOCO,"5/24/2024 12 a.m. CDT",25680,25445,26192,512
SOCO,"5/24/2024 1 a.m. CDT",24492,23774,24848,356
SOCO,"5/24/2024 2 a.m. CDT",23339,22602,23713,374
SOCO,"5/24/2024 3 a.m. CDT",22691,21987,23095,404
SOCO,"5/24/2024 4 a.m. CDT",22576,21865,22940,364
SOCO,"5/24/2024 5 a.m. CDT",23259,22285,23680,421
SOCO,"5/24/2024 6 a.m. CDT",24250,23211,24973,723
SOCO,"5/24/2024 7 a.m. CDT",24522,24176,25769,1247
SOCO,"5/24/2024 8 a.m. CDT",25168,25483,26243,1075
SOCO,"5/24/2024 9 a.m. CDT",26423,27348,27424,1001
SOCO,"5/24/2024 10 a.m. CDT",27799,29548,29027,1228
SOCO,"5/24/2024 11 a.m. CDT",30066,31956,31358,1292
SOCO,"5/24/2024 12 p.m. CDT",31801,33912,33614,1813
SOCO,"5/24/2024 1 p.m. CDT",33146,35174,35030,1884
SOCO,"5/24/2024 2 p.m. CDT",34320,36147,36208,1888
SOCO,"5/24/2024 3 p.m. CDT",34690,36385,36856,2166
SOCO,"5/24/2024 4 p.m. CDT",34098,35856,36400,2302
SOCO,"5/24/2024 5 p.m. CDT",33511,35075,36030,2519
SOCO,"5/24/2024 6 p.m. CDT",33029,34170,35604,2575
SOCO,"5/24/2024 7 p.m. CDT",32469,32988,34944,2475
SOCO,"5/24/2024 8 p.m. CDT",31501,31523,33724,2223
SOCO,"5/24/2024 9 p.m. CDT",30562,30661,33222,2660
SOCO,"5/24/2024 10 p.m. CDT",29026,28912,31151,2125
SOCO,"5/24/2024 11 p.m. CDT",27120,26967,28222,1102
SOCO,"5/25/2024 12 a.m. CDT",25166,25063,25630,464
SOCO,"5/25/2024 1 a.m. CDT",24538,23556,24475,-63
SOCO,"5/25/2024 2 a.m. CDT",23335,22357,23310,-25
SOCO,"5/25/2024 3 a.m. CDT",22652,21676,22660,8
SOCO,"5/25/2024 4 a.m. CDT",22120,21120,22153,33
SOCO,"5/25/2024 5 a.m. CDT",22094,21082,21985,-109
SOCO,"5/25/2024 6 a.m. CDT",22324,21145,22309,-15
SOCO,"5/25/2024 7 a.m. CDT",22435,21510,23025,590
SOCO,"5/25/2024 8 a.m. CDT",23674,22726,24401,727
SOCO,"5/25/2024 9 a.m. CDT",25346,24393,26051,705
SOCO,"5/25/2024 10 a.m. CDT",26648,26007,27383,735
SOCO,"5/25/2024 11 a.m. CDT",27587,27275,28957,1370
SOCO,"5/25/2024 12 p.m. CDT",28730,28397,30033,1303
SOCO,"5/25/2024 1 p.m. CDT",29745,29456,31696,1951
SOCO,"5/25/2024 2 p.m. CDT",30759,30446,33011,2252
SOCO,"5/25/2024 3 p.m. CDT",31918,31592,34168,2250
SOCO,"5/25/2024 4 p.m. CDT",33044,32763,35239,2195
SOCO,"5/25/2024 5 p.m. CDT",32111,33130,34248,2137
SOCO,"5/25/2024 6 p.m. CDT",31782,32777,33753,1971
SOCO,"5/25/2024 7 p.m. CDT",30792,31754,32744,1952
SOCO,"5/25/2024 8 p.m. CDT",29295,30173,31162,1867
SOCO,"5/25/2024 9 p.m. CDT",28399,29291,30256,1857
SOCO,"5/25/2024 10 p.m. CDT",26906,27549,28800,1894
SOCO,"5/25/2024 11 p.m. CDT",25498,25978,26341,843
SOCO,"5/26/2024 12 a.m. CDT",24197,24031,24519,322
SOCO,"5/26/2024 1 a.m. CDT",22817,22494,23114,297
SOCO,"5/26/2024 2 a.m. CDT",22111,21417,22504,393
SOCO,"5/26/2024 3 a.m. CDT",21397,20700,21840,443
SOCO,"5/26/2024 4 a.m. CDT",20901,20230,21163,262
SOCO,"5/26/2024 5 a.m. CDT",20809,20117,21111,302
SOCO,"5/26/2024 6 a.m. CDT",20957,19902,21405,448
SOCO,"5/26/2024 7 a.m. CDT",21144,20343,22029,885
SOCO,"5/26/2024 8 a.m. CDT",22728,22005,23979,1251
SOCO,"5/26/2024 9 a.m. CDT",24662,24244,25975,1313
SOCO,"5/26/2024 10 a.m. CDT",26748,26591,28099,1351
SOCO,"5/26/2024 11 a.m. CDT",28808,29241,30319,1511
SOCO,"5/26/2024 12 p.m. CDT",31033,31714,32451,1418
SOCO,"5/26/2024 1 p.m. CDT",32874,33759,34747,1873
SOCO,"5/26/2024 2 p.m. CDT",33941,35013,36100,2159
SOCO,"5/26/2024 3 p.m. CDT",34887,36020,37273,2386
SOCO,"5/26/2024 4 p.m. CDT",36686,36548,38977,2291
SOCO,"5/26/2024 5 p.m. CDT",36776,36624,38909,2133
SOCO,"5/26/2024 6 p.m. CDT",36211,36151,38520,2309
SOCO,"5/26/2024 7 p.m. CDT",34975,34968,37063,2088
SOCO,"5/26/2024 8 p.m. CDT",33352,33030,34844,1492
SOCO,"5/26/2024 9 p.m. CDT",32172,31843,33561,1389
SOCO,"5/26/2024 10 p.m. CDT",30137,29876,31564,1427
SOCO,"5/26/2024 11 p.m. CDT",28377,27864,29251,874
SOCO,"5/27/2024 12 a.m. CDT",26404,25917,26975,571
SOCO,"5/27/2024 1 a.m. CDT",24920,24463,25137,217
SOCO,"5/27/2024 2 a.m. CDT",24193,23335,24535,342
SOCO,"5/27/2024 3 a.m. CDT",23381,22527,23779,398
SOCO,"5/27/2024 4 a.m. CDT",23110,22279,23537,427
SOCO,"5/27/2024 5 a.m. CDT",23183,22350,23495,312
SOCO,"5/27/2024 6 a.m. CDT",23436,22277,24006,570
SOCO,"5/27/2024 7 a.m. CDT",23014,22047,24010,996
SOCO,"5/27/2024 8 a.m. CDT",23214,22573,24466,1252
SOCO,"5/27/2024 9 a.m. CDT",24244,23624,25626,1382
SOCO,"5/27/2024 10 a.m. CDT",25562,25121,26963,1401
SOCO,"5/27/2024 11 a.m. CDT",27451,27125,29106,1655
SOCO,"5/27/2024 12 p.m. CDT",29288,28919,31288,2000
SOCO,"5/27/2024 1 p.m. CDT",30995,30597,33364,2369
SOCO,"5/27/2024 2 p.m. CDT",32423,32047,34872,2449
SOCO,"5/27/2024 3 p.m. CDT",33521,33085,35798,2277
SOCO,"5/27/2024 4 p.m. CDT",34459,34005,36499,2040
SOCO,"5/27/2024 5 p.m. CDT",34901,34479,36715,1814
SOCO,"5/27/2024 6 p.m. CDT",34453,34098,36413,1960
SOCO,"5/27/2024 7 p.m. CDT",33320,32951,35418,2098
SOCO,"5/27/2024 8 p.m. CDT",31896,31541,33873,1977
SOCO,"5/27/2024 9 p.m. CDT",30654,30298,32607,1953
SOCO,"5/27/2024 10 p.m. CDT",28642,28209,30352,1710
SOCO,"5/27/2024 11 p.m. CDT",26541,25983,27349,808
SOCO,"5/28/2024 12 a.m. CDT",24488,23986,24962,474
SOCO,"5/28/2024 1 a.m. CDT",23189,22354,23722,533
SOCO,"5/28/2024 2 a.m. CDT",22565,21336,23086,521
SOCO,"5/28/2024 3 a.m. CDT",21825,20654,22449,624
SOCO,"5/28/2024 4 a.m. CDT",21510,20452,22125,615
SOCO,"5/28/2024 5 a.m. CDT",22065,20992,22783,718
SOCO,"5/28/2024 6 a.m. CDT",22662,21958,23459,797
SOCO,"5/28/2024 7 a.m. CDT",24037,23294,25430,1393
SOCO,"5/28/2024 8 a.m. CDT",25883,25097,27352,1469
SOCO,"5/28/2024 9 a.m. CDT",27649,26941,29079,1430
SOCO,"5/28/2024 10 a.m. CDT",29562,29051,30971,1409
SOCO,"5/28/2024 11 a.m. CDT",31570,31166,33005,1435
SOCO,"5/28/2024 12 p.m. CDT",33332,32912,34643,1311
SOCO,"5/28/2024 1 p.m. CDT",35226,34777,36541,1315
SOCO,"5/28/2024 2 p.m. CDT",36590,36119,38349,1759
SOCO,"5/28/2024 3 p.m. CDT",37475,37000,38963,1488
SOCO,"5/28/2024 4 p.m. CDT",37828,37412,39316,1488
SOCO,"5/28/2024 5 p.m. CDT",37650,37263,39122,1472
SOCO,"5/28/2024 6 p.m. CDT",36854,36520,38360,1506
SOCO,"5/28/2024 7 p.m. CDT",35545,35239,36954,1409
SOCO,"5/28/2024 8 p.m. CDT",33601,33343,35193,1592
SOCO,"5/28/2024 9 p.m. CDT",32100,31849,33812,1712
SOCO,"5/28/2024 10 p.m. CDT",29466,29172,31136,1670
SOCO,"5/28/2024 11 p.m. CDT",26699,26444,27549,850
SOCO,"5/29/2024 12 a.m. CDT",24474,24254,25250,776
SOCO,"5/29/2024 1 a.m. CDT",23262,22700,23897,635
SOCO,"5/29/2024 2 a.m. CDT",22328,21596,23032,704
SOCO,"5/29/2024 3 a.m. CDT",21749,20849,22372,623
SOCO,"5/29/2024 4 a.m. CDT",21506,20601,22223,717
SOCO,"5/29/2024 5 a.m. CDT",21815,20936,22599,784
SOCO,"5/29/2024 6 a.m. CDT",22593,21702,23441,848
SOCO,"5/29/2024 7 a.m. CDT",23362,22798,24572,1210
SOCO,"5/29/2024 8 a.m. CDT",24668,24090,26147,1479
SOCO,"5/29/2024 9 a.m. CDT",26257,25673,27853,1596
SOCO,"5/29/2024 10 a.m. CDT",27662,27414,29036,1374
SOCO,"5/29/2024 11 a.m. CDT",29344,29046,30619,1275
SOCO,"5/29/2024 12 p.m. CDT",30921,30583,32040,1119
SOCO,"5/29/2024 1 p.m. CDT",32704,32332,33978,1274
SOCO,"5/29/2024 2 p.m. CDT",34050,33675,35126,1076
SOCO,"5/29/2024 3 p.m. CDT",35186,34755,36446,1260
SOCO,"5/29/2024 4 p.m. CDT",35970,35521,37291,1321
SOCO,"5/29/2024 5 p.m. CDT",35701,35313,36869,1168
SOCO,"5/29/2024 6 p.m. CDT",34910,34588,36208,1298
SOCO,"5/29/2024 7 p.m. CDT",33567,33241,34692,1125
SOCO,"5/29/2024 8 p.m. CDT",31855,31518,33045,1190
SOCO,"5/29/2024 9 p.m. CDT",30486,30192,31924,1438
SOCO,"5/29/2024 10 p.m. CDT",28337,28091,29562,1225
SOCO,"5/29/2024 11 p.m. CDT",25990,25778,26739,749
SOCO,"5/30/2024 12 a.m. CDT",23959,23763,24504,545
SOCO,"5/30/2024 1 a.m. CDT",22900,22189,23672,772
SOCO,"5/30/2024 2 a.m. CDT",22209,21087,22880,671
SOCO,"5/30/2024 3 a.m. CDT",21511,20408,22286,775
SOCO,"5/30/2024 4 a.m. CDT",21337,20224,22135,798
SOCO,"5/30/2024 5 a.m. CDT",21488,20551,22349,861
SOCO,"5/30/2024 6 a.m. CDT",21931,21364,22801,870
SOCO,"5/30/2024 7 a.m. CDT",22951,22390,24084,1133
SOCO,"5/30/2024 8 a.m. CDT",24049,23480,25230,1181
SOCO,"5/30/2024 9 a.m. CDT",25031,24582,26523,1492
SOCO,"5/30/2024 10 a.m. CDT",26074,25821,27461,1387
SOCO,"5/30/2024 11 a.m. CDT",27304,27021,28708,1404
SOCO,"5/30/2024 12 p.m. CDT",28629,28317,30520,1891
SOCO,"5/30/2024 1 p.m. CDT",30266,29924,32218,1952
SOCO,"5/30/2024 2 p.m. CDT",31771,31406,33889,2118
SOCO,"5/30/2024 3 p.m. CDT",32931,32572,35389,2458
SOCO,"5/30/2024 4 p.m. CDT",33785,33432,35779,1994
SOCO,"5/30/2024 5 p.m. CDT",34056,33707,36050,1994
SOCO,"5/30/2024 6 p.m. CDT",33517,33246,35454,1937
SOCO,"5/30/2024 7 p.m. CDT",32401,32165,34485,2084
SOCO,"5/30/2024 8 p.m. CDT",30835,30622,32668,1833
SOCO,"5/30/2024 9 p.m. CDT",29673,29434,31228,1555
SOCO,"5/30/2024 10 p.m. CDT",27541,27288,29066,1525
SOCO,"5/30/2024 11 p.m. CDT",25224,25009,26350,1126
SOCO,"5/31/2024 12 a.m. CDT",22977,23021,23925,948
SOCO,"5/31/2024 1 a.m. CDT",22229,21574,23087,858
SOCO,"5/31/2024 2 a.m. CDT",21449,20630,22299,850
SOCO,"5/31/2024 3 a.m. CDT",21111,20069,21996,885
SOCO,"5/31/2024 4 a.m. CDT",20953,19904,21901,948
SOCO,"5/31/2024 5 a.m. CDT",21199,20317,22153,954
SOCO,"5/31/2024 6 a.m. CDT",21674,21028,22835,1161
SOCO,"5/31/2024 7 a.m. CDT",22632,22051,24117,1485
SOCO,"5/31/2024 8 a.m. CDT",23871,23293,25394,1523
SOCO,"5/31/2024 9 a.m. CDT",25133,24501,26614,1481
SOCO,"5/31/2024 10 a.m. CDT",26607,26085,28062,1455
SOCO,"5/31/2024 11 a.m. CDT",28041,27677,29335,1294
SOCO,"5/31/2024 12 p.m. CDT",29629,29283,30870,1241
SOCO,"5/31/2024 1 p.m. CDT",31176,30832,32349,1173
SOCO,"5/31/2024 2 p.m. CDT",32458,32101,33788,1330
SOCO,"5/31/2024 3 p.m. CDT",33496,33153,35058,1562
SOCO,"5/31/2024 4 p.m. CDT",33943,33628,35638,1695
SOCO,"5/31/2024 5 p.m. CDT",33645,33368,35011,1366
SOCO,"5/31/2024 6 p.m. CDT",32689,32393,33853,1164
SOCO,"5/31/2024 7 p.m. CDT",31358,31145,32653,1295
SOCO,"5/31/2024 8 p.m. CDT",29997,29818,31394,1397
SOCO,"5/31/2024 9 p.m. CDT",29068,28853,30476,1408
SOCO,"5/31/2024 10 p.m. CDT",27493,27261,28608,1115
SOCO,"5/31/2024 11 p.m. CDT",25552,25323,26306,754
SOCO,"6/1/2024 12 a.m. CDT",23675,23479,24288,613
