"BA Code","Timestamp (Hour Ending)","Demand (MWh)","Demand Forecast (MWh)","Net Generation (MWh)","Total Interchange (MWh)"
SOCO,"11/1/2024 12 a.m. CDT",21995,21383,22472,477
SOCO,"11/1/2024 1 a.m. CDT",21352,20350,21866,514
SOCO,"11/1/2024 2 a.m. CDT",20766,19739,21337,571
SOCO,"11/1/2024 3 a.m. CDT",20535,19502,20997,462
SOCO,"11/1/2024 4 a.m. CDT",20618,19601,20980,362
SOCO,"11/1/2024 5 a.m. CDT",20973,20242,21094,121
SOCO,"11/1/2024 6 a.m. CDT",22016,21646,22219,203
SOCO,"11/1/2024 7 a.m. CDT",23191,22952,23647,456
SOCO,"11/1/2024 8 a.m. CDT",23515,23277,24224,709
SOCO,"11/1/2024 9 a.m. CDT",24230,23769,25176,946
SOCO,"11/1/2024 10 a.m. CDT",25045,24344,26156,1111
SOCO,"11/1/2024 11 a.m. CDT",25411,24973,26569,1158
SOCO,"11/1/2024 12 p.m. CDT",25866,25519,26910,1044
SOCO,"11/1/2024 1 p.m. CDT",26471,26108,27422,951
SOCO,"11/1/2024 2 p.m. CDT",26600,26411,27572,972
SOCO,"11/1/2024 3 p.m. CDT",26739,26530,27605,866
SOCO,"11/1/2024 4 p.m. CDT",26720,26533,27534,814
SOCO,"11/1/2024 5 p.m. CDT",26697,26473,27445,748
SOCO,"11/1/2024 6 p.m. CDT",26358,26229,26958,600
SOCO,"11/1/2024 7 p.m. CDT",26334,26236,26846,512
SOCO,"11/1/2024 8 p.m. CDT",25593,25534,26133,540
SOCO,"11/1/2024 9 p.m. CDT",24646,24595,25463,817
SOCO,"11/1/2024 10 p.m. CDT",23589,23550,24525,936
SOCO,"11/1/2024 11 p.m. CDT",22465,22317,23029,564
SOCO,"11/2/2024 12 a.m. CDT",21256,21101,21655,399
SOCO,"11/2/2024 1 a.m. CDT",20471,20055,21254,783
SOCO,"11/2/2024 2 a.m. CDT",19894,19340,20720,826
SOCO,"11/2/2024 3 a.m. CDT",19368,18831,20208,840
SOCO,"11/2/2024 4 a.m. CDT",19221,18684,20147,926
SOCO,"11/2/2024 5 a.m. CDT",19351,18822,20276,925
SOCO,"11/2/2024 6 a.m. CDT",19776,19261,20601,825
SOCO,"11/2/2024 7 a.m. CDT",20571,20045,21523,952
SOCO,"11/2/2024 8 a.m. CDT",21354,20812,22130,776
SOCO,"11/2/2024 9 a.m. CDT",22411,21783,23783,1372
SOCO,"11/2/2024 10 a.m. CDT",23407,22739,24955,1548
SOCO,"11/2/2024 11 a.m. CDT",24287,23643,25813,1526
SOCO,"11/2/2024 12 p.m. CDT",24850,24537,26306,1456
SOCO,"11/2/2024 1 p.m. CDT",25641,25478,26853,1212
SOCO,"11/2/2024 2 p.m. CDT",26485,26342,27680,1195
SOCO,"11/2/2024 3 p.m. CDT",27043,26904,28284,1241
SOCO,"11/2/2024 4 p.m. CDT",27213,27073,28445,1232
SOCO,"11/2/2024 5 p.m. CDT",26998,26874,28219,1221
SOCO,"11/2/2024 6 p.m. CDT",26321,26252,27691,1370
SOCO,"11/2/2024 7 p.m. CDT",26036,25971,27194,1158
SOCO,"11/2/2024 8 p.m. CDT",25208,25103,25866,658
SOCO,"11/2/2024 9 p.m. CDT",24326,24198,24897,571
SOCO,"11/2/2024 10 p.m. CDT",23269,23195,23813,544
SOCO,"11/2/2024 11 p.m. CDT",21978,21864,22668,690
SOCO,"11/3/2024 12 a.m. CDT",20747,20641,21798,1051
SOCO,"11/3/2024 1 a.m. CDT",18369,18875,19499,1130
SOCO,"11/3/2024 1 a.m. CST",19290,18414,20403,1113
SOCO,"11/3/2024 2 a.m. CST",18599,18156,19688,1089
SOCO,"11/3/2024 3 a.m. CST",18447,18080,19518,1071
SOCO,"11/3/2024 4 a.m. CST",18746,18250,19631,885
SOCO,"11/3/2024 5 a.m. CST",19267,18770,20243,976
SOCO,"11/3/2024 6 a.m. CST",20058,19532,21168,1110
SOCO,"11/3/2024 7 a.m. CST",21546,20964,22677,1131
SOCO,"11/3/2024 8 a.m. CST",22649,22175,23987,1338
SOCO,"11/3/2024 9 a.m. CST",23257,22915,24596,1339
SOCO,"11/3/2024 10 a.m. CST",23903,23530,25419,1516
SOCO,"11/3/2024 11 a.m. CST",24437,24088,25922,1485
SOCO,"11/3/2024 12 p.m. CST",24940,24561,26103,1163
SOCO,"11/3/2024 1 p.m. CST",25232,24867,26356,1124
SOCO,"11/3/2024 2 p.m. CST",25317,24962,26629,1312
SOCO,"11/3/2024 3 p.m. CST",25336,24994,26733,1397
SOCO,"11/3/2024 4 p.m. CST",25416,25191,26587,1171
SOCO,"11/3/2024 5 p.m. CST",25772,25746,27037,1265
SOCO,"11/3/2024 6 p.m. CST",25158,25279,26365,1207
SOCO,"11/3/2024 7 p.m. CST",24663,24523,25675,1012
SOCO,"11/3/2024 8 p.m. CST",23700,23448,24672,972
SOCO,"11/3/2024 9 p.m. CST",22443,22095,23244,801
SOCO,"11/3/2024 10 p.m. CST",21360,20688,22277,917
SOCO,"11/3/2024 11 p.m. CST",20111,19655,21352,1241
SOCO,"11/4/2024 12 a.m. CST",19583,,20785,1202
SOCO,"11/4/2024 1 a.m. CST",19583,18984,20785,1202
SOCO,"11/4/2024 2 a.m. CST",19221,18625,20281,1060
SOCO,"11/4/2024 3 a.m. CST",19047,18454,19997,950
SOCO,"11/4/2024 4 a.m. CST",19410,18787,20242,832
SOCO,"11/4/2024 5 a.m. CST",20353,19759,21290,937
SOCO,"11/4/2024 6 a.m. CST",21894,21651,22791,897
SOCO,"11/4/2024 7 a.m. CST",23098,22844,24209,1111
SOCO,"11/4/2024 8 a.m. CST",23932,23636,25369,1437
SOCO,"11/4/2024 9 a.m. CST",24546,24227,25932,1386
SOCO,"11/4/2024 10 a.m. CST",25002,24782,26252,1250
SOCO,"11/4/2024 11 a.m. CST",25443,25221,26696,1253
SOCO,"11/4/2024 12 p.m. CST",25895,25668,27332,1437
SOCO,"11/4/2024 1 p.m. CST",26234,26023,27598,1364
SOCO,"11/4/2024 2 p.m. CST",26418,26192,27923,1505
SOCO,"11/4/2024 3 p.m. CST",26578,26427,28203,1625
SOCO,"11/4/2024 4 p.m. CST",26548,26424,28202,1654
SOCO,"11/4/2024 5 p.m. CST",26641,26553,28122,1481
SOCO,"11/4/2024 6 p.m. CST",27130,27021,28319,1189
SOCO,"11/4/2024 7 p.m. CST",26797,26679,27915,1118
SOCO,"11/4/2024 8 p.m. CST",26073,25932,27285,1212
SOCO,"11/4/2024 9 p.m. CST",25072,24964,26368,1296
SOCO,"11/4/2024 10 p.m. CST",23741,23498,24861,1120
SOCO,"11/4/2024 11 p.m. CST",22466,22139,23359,893
SOCO,"11/5/2024 12 a.m. CST",21551,20972,22472,921
SOCO,"11/5/2024 1 a.m. CST",21324,20224,22454,1130
SOCO,"11/5/2024 2 a.m. CST",20803,19662,21933,1130
SOCO,"11/5/2024 3 a.m. CST",20648,19518,21877,1229
SOCO,"11/5/2024 4 a.m. CST",20957,19834,22159,1202
SOCO,"11/5/2024 5 a.m. CST",21346,20679,22249,903
SOCO,"11/5/2024 6 a.m. CST",22502,22248,23591,1089
SOCO,"11/5/2024 7 a.m. CST",23684,23428,25047,1363
SOCO,"11/5/2024 8 a.m. CST",24429,24153,25867,1438
SOCO,"11/5/2024 9 a.m. CST",25129,24801,26590,1461
SOCO,"11/5/2024 10 a.m. CST",25650,25451,27087,1437
SOCO,"11/5/2024 11 a.m. CST",26655,26051,27909,1254
SOCO,"11/5/2024 12 p.m. CST",27431,26830,28713,1282
SOCO,"11/5/2024 1 p.m. CST",27761,27538,29162,1401
SOCO,"11/5/2024 2 p.m. CST",28173,27942,29513,1340
SOCO,"11/5/2024 3 p.m. CST",28077,27884,29341,1264
SOCO,"11/5/2024 4 p.m. CST",27973,27865,29085,1112
SOCO,"11/5/2024 5 p.m. CST",27850,27798,28704,854
SOCO,"11/5/2024 6 p.m. CST",28395,28260,29250,855
SOCO,"11/5/2024 7 p.m. CST",27860,27685,28453,593
SOCO,"11/5/2024 8 p.m. CST",27017,26869,27624,607
SOCO,"11/5/2024 9 p.m. CST",25989,25850,26737,748
SOCO,"11/5/2024 10 p.m. CST",24749,24481,25883,1134
SOCO,"11/5/2024 11 p.m. CST",23433,23024,24726,1293
SOCO,"11/6/2024 12 a.m. CST",22643,21891,23680,1037
SOCO,"11/6/2024 1 a.m. CST",22190,21066,23180,990
SOCO,"11/6/2024 2 a.m. CST",21572,20414,22599,1027
SOCO,"11/6/2024 3 a.m. CST",21230,20137,22358,1128
SOCO,"11/6/2024 4 a.m. CST",21460,20334,22501,1041
SOCO,"11/6/2024 5 a.m. CST",22119,21141,22902,783
SOCO,"11/6/2024 6 a.m. CST",23392,22799,24332,940
SOCO,"11/6/2024 7 a.m. CST",24215,23952,25571,1356
SOCO,"11/6/2024 8 a.m. CST",24943,24657,26373,1430
SOCO,"11/6/2024 9 a.m. CST",25727,25453,27219,1492
SOCO,"11/6/2024 10 a.m. CST",26441,26145,27833,1392
SOCO,"11/6/2024 11 a.m. CST",26970,26663,28351,1381
SOCO,"11/6/2024 12 p.m. CST",27407,27122,29017,1610
SOCO,"11/6/2024 1 p.m. CST",27565,27364,29264,1699
SOCO,"11/6/2024 2 p.m. CST",27689,27522,29524,1835
SOCO,"11/6/2024 3 p.m. CST",27584,27431,29462,1878
SOCO,"11/6/2024 4 p.m. CST",27559,27463,29856,2297
SOCO,"11/6/2024 5 p.m. CST",27847,27751,29929,2082
SOCO,"11/6/2024 6 p.m. CST",28499,28374,30180,1681
SOCO,"11/6/2024 7 p.m. CST",28081,27852,29512,1431
SOCO,"11/6/2024 8 p.m. CST",27383,27231,28513,1130
SOCO,"11/6/2024 9 p.m. CST",26537,26395,27774,1237
SOCO,"11/6/2024 10 p.m. CST",25291,25035,26560,1269
SOCO,"11/6/2024 11 p.m. CST",24114,23516,25350,1236
SOCO,"11/7/2024 12 a.m. CST",23367,22421,24404,1037
SOCO,"11/7/2024 1 a.m. CST",22105,21533,23342,1237
SOCO,"11/7/2024 2 a.m. CST",21472,20886,22636,1164
SOCO,"11/7/2024 3 a.m. CST",21141,20576,22363,1222
SOCO,"11/7/2024 4 a.m. CST",21253,20694,22495,1242
SOCO,"11/7/2024 5 a.m. CST",21902,21472,22829,927
SOCO,"11/7/2024 6 a.m. CST",23169,23159,24538,1369
SOCO,"11/7/2024 7 a.m. CST",24104,24497,25796,1692
SOCO,"11/7/2024 8 a.m. CST",24552,25009,26170,1618
SOCO,"11/7/2024 9 a.m. CST",24887,25524,26735,1848
SOCO,"11/7/2024 10 a.m. CST",25640,26365,27311,1671
SOCO,"11/7/2024 11 a.m. CST",26151,26903,27469,1318
SOCO,"11/7/2024 12 p.m. CST",26166,27440,27763,1597
SOCO,"11/7/2024 1 p.m. CST",26485,27798,28017,1532
SOCO,"11/7/2024 2 p.m. CST",26686,27976,28486,1800
SOCO,"11/7/2024 3 p.m. CST",26930,27957,28941,2011
SOCO,"11/7/2024 4 p.m. CST",26268,28029,28079,1811
SOCO,"11/7/2024 5 p.m. CST",27485,28130,29229,1744
SOCO,"11/7/2024 6 p.m. CST",27911,28493,29291,1380
SOCO,"11/7/2024 7 p.m. CST",27530,28095,29052,1522
SOCO,"11/7/2024 8 p.m. CST",26861,27366,28388,1527
SOCO,"11/7/2024 9 p.m. CST",25757,26323,27387,1630
SOCO,"11/7/2024 10 p.m. CST",24523,25009,26036,1513
SOCO,"11/7/2024 11 p.m. CST",23316,23483,24447,1131
SOCO,"11/8/2024 12 a.m. CST",22650,22253,23838,1188
SOCO,"11/8/2024 1 a.m. CST",22420,21210,23476,1056
SOCO,"11/8/2024 2 a.m. CST",21752,20523,22717,965
SOCO,"11/8/2024 3 a.m. CST",21532,20290,22595,1063
SOCO,"11/8/2024 4 a.m. CST",21642,20428,22692,1050
SOCO,"11/8/2024 5 a.m. CST",22293,21566,23277,984
SOCO,"11/8/2024 6 a.m. CST",23279,22987,24443,1164
SOCO,"11/8/2024 7 a.m. CST",24075,23968,25406,1331
SOCO,"11/8/2024 8 a.m. CST",24796,24771,26184,1388
SOCO,"11/8/2024 9 a.m. CST",25507,25729,26786,1279
SOCO,"11/8/2024 10 a.m. CST",26273,26659,27314,1041
SOCO,"11/8/2024 11 a.m. CST",26998,27479,27556,558
SOCO,"11/8/2024 12 p.m. CST",27777,28387,28328,551
SOCO,"11/8/2024 1 p.m. CST",28335,29186,28948,613
SOCO,"11/8/2024 2 p.m. CST",28734,29499,29573,839
SOCO,"11/8/2024 3 p.m. CST",28836,29245,29613,777
SOCO,"11/8/2024 4 p.m. CST",28679,28864,29146,467
SOCO,"11/8/2024 5 p.m. CST",28141,28406,28904,763
SOCO,"11/8/2024 6 p.m. CST",28127,28575,29149,1022
SOCO,"11/8/2024 7 p.m. CST",27278,27476,28227,949
SOCO,"11/8/2024 8 p.m. CST",26252,26462,27105,853
SOCO,"11/8/2024 9 p.m. CST",25253,25523,26463,1210
SOCO,"11/8/2024 10 p.m. CST",24007,24437,25284,1277
SOCO,"11/8/2024 11 p.m. CST",23065,23273,24302,1237
SOCO,"11/9/2024 12 a.m. CST",22141,22210,23075,934
SOCO,"11/9/2024 1 a.m. CST",21187,20552,22038,851
SOCO,"11/9/2024 2 a.m. CST",20451,19725,21381,930
SOCO,"11/9/2024 3 a.m. CST",20246,19249,21142,896
SOCO,"11/9/2024 4 a.m. CST",20082,19086,20996,914
SOCO,"11/9/2024 5 a.m. CST",20429,19418,21291,862
SOCO,"11/9/2024 6 a.m. CST",20848,19834,21717,869
SOCO,"11/9/2024 7 a.m. CST",20768,20358,22073,1305
SOCO,"11/9/2024 8 a.m. CST",21620,21455,23200,1580
SOCO,"11/9/2024 9 a.m. CST",22925,22697,24614,1689
SOCO,"11/9/2024 10 a.m. CST",23926,23658,25497,1571
SOCO,"11/9/2024 11 a.m. CST",24841,24539,26220,1379
SOCO,"11/9/2024 12 p.m. CST",25518,25215,26990,1472
SOCO,"11/9/2024 1 p.m. CST",25957,25667,27365,1408
SOCO,"11/9/2024 2 p.m. CST",26108,25817,27610,1502
SOCO,"11/9/2024 3 p.m. CST",25988,25727,27486,1498
SOCO,"11/9/2024 4 p.m. CST",25619,25400,27031,1412
SOCO,"11/9/2024 5 p.m. CST",25551,25364,27154,1603
SOCO,"11/9/2024 6 p.m. CST",25736,25592,27187,1451
SOCO,"11/9/2024 7 p.m. CST",25197,25018,26653,1456
SOCO,"11/9/2024 8 p.m. CST",24431,24258,25804,1373
SOCO,"11/9/2024 9 p.m. CST",23740,23552,25371,1631
SOCO,"11/9/2024 10 p.m. CST",22826,22513,24337,1511
SOCO,"11/9/2024 11 p.m. CST",21861,21531,23331,1470
SOCO,"11/10/2024 12 a.m. CST",20780,20468,22204,1424
SOCO,"11/10/2024 1 a.m. CST",20269,19616,21707,1438
SOCO,"11/10/2024 2 a.m. CST",20066,19027,21677,1611
SOCO,"11/10/2024 3 a.m. CST",19726,18672,21299,1573
SOCO,"11/10/2024 4 a.m. CST",19463,18439,21007,1544
SOCO,"11/10/2024 5 a.m. CST",19536,18525,21112,1576
SOCO,"11/10/2024 6 a.m. CST",19593,18859,21134,1541
SOCO,"11/10/2024 7 a.m. CST",20131,19490,21924,1793
SOCO,"11/10/2024 8 a.m. CST",21223,20523,22952,1729
SOCO,"11/10/2024 9 a.m. CST",21927,21592,23708,1781
SOCO,"11/10/2024 10 a.m. CST",22478,22211,24497,2019
SOCO,"11/10/2024 11 a.m. CST",22807,22598,24770,1963
SOCO,"11/10/2024 12 p.m. CST",23107,22900,25071,1964
SOCO,"11/10/2024 1 p.m. CST",23354,23140,25279,1925
SOCO,"11/10/2024 2 p.m. CST",23448,23269,25286,1838
SOCO,"11/10/2024 3 p.m. CST",23376,23214,25385,2009
SOCO,"11/10/2024 4 p.m. CST",23574,23427,25763,2189
SOCO,"11/10/2024 5 p.m. CST",24207,24075,26480,2273
SOCO,"11/10/2024 6 p.m. CST",24891,24755,26969,2078
SOCO,"11/10/2024 7 p.m. CST",24618,24463,26490,1872
SOCO,"11/10/2024 8 p.m. CST",23983,23796,25898,1915
SOCO,"11/10/2024 9 p.m. CST",23186,23034,25142,1956
SOCO,"11/10/2024 10 p.m. CST",22175,22026,23932,1757
SOCO,"11/10/2024 11 p.m. CST",21110,20818,22834,1724
SOCO,"11/11/2024 12 a.m. CST",20492,19846,22137,1645
SOCO,"11/11/2024 1 a.m. CST",19799,19184,21304,1505
SOCO,"11/11/2024 2 a.m. CST",19684,18736,21130,1446
SOCO,"11/11/2024 3 a.m. CST",19597,18605,21058,1461
SOCO,"11/11/2024 4 a.m. CST",19873,18888,21226,1353
SOCO,"11/11/2024 5 a.m. CST",20537,19751,21862,1325
SOCO,"11/11/2024 6 a.m. CST",21514,21228,22991,1477
SOCO,"11/11/2024 7 a.m. CST",22525,22377,24364,1839
SOCO,"11/11/2024 8 a.m. CST",23306,23159,25185,1879
SOCO,"11/11/2024 9 a.m. CST",24077,23905,25994,1917
SOCO,"11/11/2024 10 a.m. CST",24804,24597,26672,1868
SOCO,"11/11/2024 11 a.m. CST",25347,25129,27256,1909
SOCO,"11/11/2024 12 p.m. CST",25943,25695,27958,2015
SOCO,"11/11/2024 1 p.m. CST",26492,26232,28495,2003
SOCO,"11/11/2024 2 p.m. CST",26803,26562,28836,2033
SOCO,"11/11/2024 3 p.m. CST",26996,26734,28870,1874
SOCO,"11/11/2024 4 p.m. CST",26833,26623,28487,1654
SOCO,"11/11/2024 5 p.m. CST",26824,26701,28543,1719
SOCO,"11/11/2024 6 p.m. CST",27263,27089,28724,1461
SOCO,"11/11/2024 7 p.m. CST",26701,26507,28221,1520
SOCO,"11/11/2024 8 p.m. CST",25808,25611,27235,1427
SOCO,"11/11/2024 9 p.m. CST",24706,24533,26317,1611
SOCO,"11/11/2024 10 p.m. CST",23141,23032,24731,1590
SOCO,"11/11/2024 11 p.m. CST",22257,21651,23492,1235
SOCO,"11/12/2024 12 a.m. CST",21014,20449,22248,1234
SOCO,"11/12/2024 1 a.m. CST",20747,19708,21980,1233
SOCO,"11/12/2024 2 a.m. CST",20321,19283,21676,1355
SOCO,"11/12/2024 3 a.m. CST",20014,19054,21305,1291
SOCO,"11/12/2024 4 a.m. CST",20224,19312,21473,1249
SOCO,"11/12/2024 5 a.m. CST",20749,20178,22170,1421
SOCO,"11/12/2024 6 a.m. CST",22606,22045,24148,1542
SOCO,"11/12/2024 7 a.m. CST",23356,23142,25192,1836
SOCO,"11/12/2024 8 a.m. CST",23773,23481,25729,1956
SOCO,"11/12/2024 9 a.m. CST",24100,23804,25852,1752
SOCO,"11/12/2024 10 a.m. CST",24483,24177,26296,1813
SOCO,"11/12/2024 11 a.m. CST",24880,24554,26768,1888
SOCO,"11/12/2024 12 p.m. CST",25236,24869,27180,1944
SOCO,"11/12/2024 1 p.m. CST",25729,25500,27970,2241
SOCO,"11/12/2024 2 p.m. CST",26107,25929,28323,2216
SOCO,"11/12/2024 3 p.m. CST",26229,26059,28639,2410
SOCO,"11/12/2024 4 p.m. CST",26054,25893,28437,2383
SOCO,"11/12/2024 5 p.m. CST",25948,25897,28278,2330
SOCO,"11/12/2024 6 p.m. CST",26438,26341,28607,2169
SOCO,"11/12/2024 7 p.m. CST",25936,25818,27988,2052
SOCO,"11/12/2024 8 p.m. CST",25375,25235,27171,1796
SOCO,"11/12/2024 9 p.m. CST",24324,24195,26171,1847
SOCO,"11/12/2024 10 p.m. CST",23221,22961,24986,1765
SOCO,"11/12/2024 11 p.m. CST",21889,21631,23468,1579
SOCO,"11/13/2024 12 a.m. CST",21122,20527,22654,1532
SOCO,"11/13/2024 1 a.m. CST",20765,19772,22346,1581
SOCO,"11/13/2024 2 a.m. CST",20379,19431,21848,1469
SOCO,"11/13/2024 3 a.m. CST",20271,19290,21688,1417
SOCO,"11/13/2024 4 a.m. CST",20385,19427,21702,1317
SOCO,"11/13/2024 5 a.m. CST",20657,20306,21976,1319
SOCO,"11/13/2024 6 a.m. CST",22415,22142,24233,1818
SOCO,"11/13/2024 7 a.m. CST",23634,23410,25690,2056
SOCO,"11/13/2024 8 a.m. CST",24102,23763,26185,2083
SOCO,"11/13/2024 9 a.m. CST",24344,23970,26227,1883
SOCO,"11/13/2024 10 a.m. CST",24526,24128,26525,1999
SOCO,"11/13/2024 11 a.m. CST",24708,24303,27062,2354
SOCO,"11/13/2024 12 p.m. CST",24799,24384,27329,2530
SOCO,"11/13/2024 1 p.m. CST",24822,24406,27410,2588
SOCO,"11/13/2024 2 p.m. CST",24711,24477,27046,2335
SOCO,"11/13/2024 3 p.m. CST",24626,24423,27114,2488
SOCO,"11/13/2024 4 p.m. CST",24653,24549,27341,2688
SOCO,"11/13/2024 5 p.m. CST",25346,25220,28132,2786
SOCO,"11/13/2024 6 p.m. CST",26046,25890,28779,2733
SOCO,"11/13/2024 7 p.m. CST",25814,25674,28470,2656
SOCO,"11/13/2024 8 p.m. CST",25312,25129,28136,2824
SOCO,"11/13/2024 9 p.m. CST",24564,24383,27177,2613
SOCO,"11/13/2024 10 p.m. CST",23447,23131,25976,2529
SOCO,"11/13/2024 11 p.m. CST",22124,21816,24077,1953
SOCO,"11/14/2024 12 a.m. CST",21489,20833,22866,1377
SOCO,"11/14/2024 1 a.m. CST",20812,20145,21785,973
SOCO,"11/14/2024 2 a.m. CST",20293,19636,21106,813
SOCO,"11/14/2024 3 a.m. CST",20570,19574,21351,781
SOCO,"11/14/2024 4 a.m. CST",20890,19861,21598,708
SOCO,"11/14/2024 5 a.m. CST",21115,20714,21910,795
SOCO,"11/14/2024 6 a.m. CST",22722,22424,23586,864
SOCO,"11/14/2024 7 a.m. CST",23998,23770,25070,1072
SOCO,"11/14/2024 8 a.m. CST",24416,24099,25428,1012
SOCO,"11/14/2024 9 a.m. CST",24963,24622,25940,977
SOCO,"11/14/2024 10 a.m. CST",25277,24931,26327,1050
SOCO,"11/14/2024 11 a.m. CST",25440,25115,26322,882
SOCO,"11/14/2024 12 p.m. CST",25579,25214,26370,791
SOCO,"11/14/2024 1 p.m. CST",25562,25345,26353,791
SOCO,"11/14/2024 2 p.m. CST",25475,25273,26233,758
SOCO,"11/14/2024 3 p.m. CST",25439,25225,26245,806
SOCO,"11/14/2024 4 p.m. CST",25419,25200,26438,1019
SOCO,"11/14/2024 5 p.m. CST",25581,25390,26587,1006
SOCO,"11/14/2024 6 p.m. CST",26042,25868,26900,858
SOCO,"11/14/2024 7 p.m. CST",25871,25616,26928,1057
SOCO,"11/14/2024 8 p.m. CST",25283,25048,26344,1061
SOCO,"11/14/2024 9 p.m. CST",24439,24268,25472,1033
SOCO,"11/14/2024 10 p.m. CST",23297,23033,24410,1113
SOCO,"11/14/2024 11 p.m. CST",22081,21808,23154,1073
SOCO,"11/15/2024 12 a.m. CST",21390,20763,22334,944
SOCO,"11/15/2024 1 a.m. CST",20737,20104,21740,1003
SOCO,"11/15/2024 2 a.m. CST",20386,19758,21322,936
SOCO,"11/15/2024 3 a.m. CST",20361,19715,21229,868
SOCO,"11/15/2024 4 a.m. CST",20610,19979,21409,799
SOCO,"11/15/2024 5 a.m. CST",21208,20903,21943,735
SOCO,"11/15/2024 6 a.m. CST",23020,22696,24066,1046
SOCO,"11/15/2024 7 a.m. CST",24306,23992,26195,1889
SOCO,"11/15/2024 8 a.m. CST",24567,24171,26703,2136
SOCO,"11/15/2024 9 a.m. CST",24469,24025,26224,1755
SOCO,"11/15/2024 10 a.m. CST",24243,23754,26484,2241
SOCO,"11/15/2024 11 a.m. CST",24459,23587,26530,2071
SOCO,"11/15/2024 12 p.m. CST",24264,23394,26474,2210
SOCO,"11/15/2024 1 p.m. CST",24003,23311,26229,2226
SOCO,"11/15/2024 2 p.m. CST",24005,23340,26479,2474
SOCO,"11/15/2024 3 p.m. CST",24058,23404,26460,2402
SOCO,"11/15/2024 4 p.m. CST",23919,23388,25851,1932
SOCO,"11/15/2024 5 p.m. CST",23821,23695,25905,2084
SOCO,"11/15/2024 6 p.m. CST",24361,24278,26394,2033
SOCO,"11/15/2024 7 p.m. CST",24089,23944,25819,1730
SOCO,"11/15/2024 8 p.m. CST",23613,23481,25333,1720
SOCO,"11/15/2024 9 p.m. CST",23041,22893,24747,1706
SOCO,"11/15/2024 10 p.m. CST",22476,22309,24165,1689
SOCO,"11/15/2024 11 p.m. CST",21689,21587,23238,1549
SOCO,"11/16/2024 12 a.m. CST",20890,20773,22503,1613
SOCO,"11/16/2024 1 a.m. CST",20763,20416,22168,1405
SOCO,"11/16/2024 2 a.m. CST",20252,20001,21604,1352
SOCO,"11/16/2024 3 a.m. CST",20561,19924,21810,1249
SOCO,"11/16/2024 4 a.m. CST",20674,20042,21977,1303
SOCO,"11/16/2024 5 a.m. CST",21193,20593,22438,1245
SOCO,"11/16/2024 6 a.m. CST",21639,21507,22913,1274
SOCO,"11/16/2024 7 a.m. CST",22494,22316,23958,1464
SOCO,"11/16/2024 8 a.m. CST",23354,23077,24550,1196
SOCO,"11/16/2024 9 a.m. CST",23543,23200,25002,1459
SOCO,"11/16/2024 10 a.m. CST",23368,23035,24981,1613
SOCO,"11/16/2024 11 a.m. CST",23390,22690,25014,1624
SOCO,"11/16/2024 12 p.m. CST",23124,22409,24582,1458
SOCO,"11/16/2024 1 p.m. CST",22989,22297,24495,1506
SOCO,"11/16/2024 2 p.m. CST",22870,22176,24426,1556
SOCO,"11/16/2024 3 p.m. CST",22988,22318,24161,1173
SOCO,"11/16/2024 4 p.m. CST",23065,22480,23774,709
SOCO,"11/16/2024 5 p.m. CST",23039,22854,23930,891
SOCO,"11/16/2024 6 p.m. CST",23562,23409,24434,872
SOCO,"11/16/2024 7 p.m. CST",23416,23077,24125,709
SOCO,"11/16/2024 8 p.m. CST",22978,22658,23636,658
SOCO,"11/16/2024 9 p.m. CST",22493,22164,23071,578
SOCO,"11/16/2024 10 p.m. CST",21795,21516,22467,672
SOCO,"11/16/2024 11 p.m. CST",21137,20866,21790,653
SOCO,"11/17/2024 12 a.m. CST",20436,20171,20944,508
SOCO,"11/17/2024 1 a.m. CST",19865,19644,20984,1119
SOCO,"11/17/2024 2 a.m. CST",19957,19366,21242,1285
SOCO,"11/17/2024 3 a.m. CST",19900,19305,21312,1412
SOCO,"11/17/2024 4 a.m. CST",19661,19439,21121,1460
SOCO,"11/17/2024 5 a.m. CST",19894,19785,21199,1305
SOCO,"11/17/2024 6 a.m. CST",20664,20560,21913,1249
SOCO,"11/17/2024 7 a.m. CST",21497,21327,22773,1276
SOCO,"11/17/2024 8 a.m. CST",22555,22308,23909,1354
SOCO,"11/17/2024 9 a.m. CST",22831,22508,24280,1449
SOCO,"11/17/2024 10 a.m. CST",22863,22238,24438,1575
SOCO,"11/17/2024 11 a.m. CST",22669,21928,24183,1514
SOCO,"11/17/2024 12 p.m. CST",22773,22056,24322,1549
SOCO,"11/17/2024 1 p.m. CST",22901,22202,24711,1810
SOCO,"11/17/2024 2 p.m. CST",22986,22294,25045,2059
SOCO,"11/17/2024 3 p.m. CST",23243,22587,25296,2053
SOCO,"11/17/2024 4 p.m. CST",23050,22861,24677,1627
SOCO,"11/17/2024 5 p.m. CST",23507,23388,24982,1475
SOCO,"11/17/2024 6 p.m. CST",24369,24227,25895,1526
SOCO,"11/17/2024 7 p.m. CST",24319,23991,25847,1528
SOCO,"11/17/2024 8 p.m. CST",23815,23510,25268,1453
SOCO,"11/17/2024 9 p.m. CST",23047,22756,24416,1369
SOCO,"11/17/2024 10 p.m. CST",21937,21637,23209,1272
SOCO,"11/17/2024 11 p.m. CST",20919,20489,22356,1437
SOCO,"11/18/2024 12 a.m. CST",20282,19658,21879,1597
SOCO,"11/18/2024 1 a.m. CST",20123,19160,21645,1522
SOCO,"11/18/2024 2 a.m. CST",19923,18957,21586,1663
SOCO,"11/18/2024 3 a.m. CST",20020,19058,21715,1695
SOCO,"11/18/2024 4 a.m. CST",20085,19551,21742,1657
SOCO,"11/18/2024 5 a.m. CST",20853,20760,22433,1580
SOCO,"11/18/2024 6 a.m. CST",22871,22761,24292,1421
SOCO,"11/18/2024 7 a.m. CST",24326,24178,25779,1453
SOCO,"11/18/2024 8 a.m. CST",24596,24424,26083,1487
SOCO,"11/18/2024 9 a.m. CST",24602,24387,25986,1384
SOCO,"11/18/2024 10 a.m. CST",24582,24333,26141,1559
SOCO,"11/18/2024 11 a.m. CST",25158,24528,26630,1472
SOCO,"11/18/2024 12 p.m. CST",25284,24629,26554,1270
SOCO,"11/18/2024 1 p.m. CST",25568,24921,26891,1323
SOCO,"11/18/2024 2 p.m. CST",25694,25044,26961,1267
SOCO,"11/18/2024 3 p.m. CST",25472,25088,26782,1310
SOCO,"11/18/2024 4 p.m. CST",25202,25045,26493,1291
SOCO,"11/18/2024 5 p.m. CST",25579,25455,26755,1176
SOCO,"11/18/2024 6 p.m. CST",26296,26149,27513,1217
SOCO,"11/18/2024 7 p.m. CST",26033,25921,27073,1040
SOCO,"11/18/2024 8 p.m. CST",25521,25327,26616,1095
SOCO,"11/18/2024 9 p.m. CST",24456,24285,25809,1353
SOCO,"11/18/2024 10 p.m. CST",23213,23081,24494,1281
SOCO,"11/18/2024 11 p.m. CST",21827,21685,23032,1205
SOCO,"11/19/2024 12 a.m. CST",21136,20694,22352,1216
SOCO,"11/19/2024 1 a.m. CST",20814,19971,21957,1143
SOCO,"11/19/2024 2 a.m. CST",20337,19508,21491,1154
SOCO,"11/19/2024 3 a.m. CST",20178,19346,21241,1063
SOCO,"11/19/2024 4 a.m. CST",20415,19571,21538,1123
SOCO,"11/19/2024 5 a.m. CST",21129,20504,22297,1168
SOCO,"11/19/2024 6 a.m. CST",22518,22257,23871,1353
SOCO,"11/19/2024 7 a.m. CST",23672,23515,25264,1592
SOCO,"11/19/2024 8 a.m. CST",24054,23902,25824,1770
SOCO,"11/19/2024 9 a.m. CST",24459,24297,25881,1422
SOCO,"11/19/2024 10 a.m. CST",24820,24637,26367,1547
SOCO,"11/19/2024 11 a.m. CST",25109,24941,26572,1463
SOCO,"11/19/2024 12 p.m. CST",25092,24926,26405,1313
SOCO,"11/19/2024 1 p.m. CST",25200,25072,26410,1210
SOCO,"11/19/2024 2 p.m. CST",25277,25132,26300,1023
SOCO,"11/19/2024 3 p.m. CST",25157,25026,26041,884
SOCO,"11/19/2024 4 p.m. CST",25311,25237,26288,977
SOCO,"11/19/2024 5 p.m. CST",25928,25848,26966,1038
SOCO,"11/19/2024 6 p.m. CST",26396,26300,27712,1316
SOCO,"11/19/2024 7 p.m. CST",26195,26004,27542,1347
SOCO,"11/19/2024 8 p.m. CST",25612,25392,27021,1409
SOCO,"11/19/2024 9 p.m. CST",24532,24351,26241,1709
SOCO,"11/19/2024 10 p.m. CST",23415,23108,25115,1700
SOCO,"11/19/2024 11 p.m. CST",22062,21798,23745,1683
SOCO,"11/20/2024 12 a.m. CST",21752,20760,23325,1573
SOCO,"11/20/2024 1 a.m. CST",20087,19939,21864,1777
SOCO,"11/20/2024 2 a.m. CST",19666,19546,21587,1921
SOCO,"11/20/2024 3 a.m. CST",19434,19283,21234,1800
SOCO,"11/20/2024 4 a.m. CST",19604,19434,21329,1725
SOCO,"11/20/2024 5 a.m. CST",20324,20254,21972,1648
SOCO,"11/20/2024 6 a.m. CST",21277,21877,23092,1815
SOCO,"11/20/2024 7 a.m. CST",22406,23069,24413,2007
SOCO,"11/20/2024 8 a.m. CST",22661,23411,24821,2160
SOCO,"11/20/2024 9 a.m. CST",23021,24009,25145,2124
SOCO,"11/20/2024 10 a.m. CST",23026,24417,25101,2075
SOCO,"11/20/2024 11 a.m. CST",23155,24691,25349,2194
SOCO,"11/20/2024 12 p.m. CST",23056,24774,24950,1894
SOCO,"11/20/2024 1 p.m. CST",22936,24907,24672,1736
SOCO,"11/20/2024 2 p.m. CST",22975,24956,24726,1751
SOCO,"11/20/2024 3 p.m. CST",22844,24724,24368,1524
SOCO,"11/20/2024 4 p.m. CST",23176,24415,24677,1501
SOCO,"11/20/2024 5 p.m. CST",24089,24675,25877,1788
SOCO,"11/20/2024 6 p.m. CST",24870,25366,26744,1874
SOCO,"11/20/2024 7 p.m. CST",24492,25133,26649,2157
SOCO,"11/20/2024 8 p.m. CST",24277,24806,26700,2423
SOCO,"11/20/2024 9 p.m. CST",23569,24083,25978,2409
SOCO,"11/20/2024 10 p.m. CST",22645,23000,24903,2258
SOCO,"11/20/2024 11 p.m. CST",21614,21876,23707,2093
SOCO,"11/21/2024 12 a.m. CST",21583,21106,23617,2034
SOCO,"11/21/2024 1 a.m. CST",21639,20658,23760,2121
SOCO,"11/21/2024 2 a.m. CST",21492,20496,23694,2202
SOCO,"11/21/2024 3 a.m. CST",21582,20883,23672,2090
SOCO,"11/21/2024 4 a.m. CST",21998,21897,23930,1932
SOCO,"11/21/2024 5 a.m. CST",23097,23627,25188,2091
SOCO,"11/21/2024 6 a.m. CST",25372,26476,27224,1852
SOCO,"11/21/2024 7 a.m. CST",27205,28254,29044,1839
SOCO,"11/21/2024 8 a.m. CST",27412,28537,29266,1854
SOCO,"11/21/2024 9 a.m. CST",26931,28029,29338,2407
SOCO,"11/21/2024 10 a.m. CST",26456,27423,28757,2301
SOCO,"11/21/2024 11 a.m. CST",25714,26841,28256,2542
SOCO,"11/21/2024 12 p.m. CST",25203,26105,27758,2555
SOCO,"11/21/2024 1 p.m. CST",24877,25596,27481,2604
SOCO,"11/21/2024 2 p.m. CST",24723,25147,27374,2651
SOCO,"11/21/2024 3 p.m. CST",24708,24840,27524,2816
SOCO,"11/21/2024 4 p.m. CST",24831,25018,27457,2626
SOCO,"11/21/2024 5 p.m. CST",25616,25916,28307,2691
SOCO,"11/21/2024 6 p.m. CST",26949,27263,29608,2659
SOCO,"11/21/2024 7 p.m. CST",27302,27748,30022,2720
SOCO,"11/21/2024 8 p.m. CST",27278,27941,29803,2525
SOCO,"11/21/2024 9 p.m. CST",26791,27584,29190,2399
SOCO,"11/21/2024 10 p.m. CST",25978,26718,28412,2434
SOCO,"11/21/2024 11 p.m. CST",24922,25705,27175,2253
SOCO,"11/22/2024 12 a.m. CST",24435,24997,26650,2215
SOCO,"11/22/2024 1 a.m. CST",24121,23330,26576,2455
SOCO,"11/22/2024 2 a.m. CST",23918,23083,26419,2501
SOCO,"11/22/2024 3 a.m. CST",24093,23276,26515,2422
SOCO,"11/22/2024 4 a.m. CST",24557,23919,27020,2463
SOCO,"11/22/2024 5 a.m. CST",25331,25143,27931,2600
SOCO,"11/22/2024 6 a.m. CST",27428,27239,29657,2229
SOCO,"11/22/2024 7 a.m. CST",29028,28844,31338,2310
SOCO,"11/22/2024 8 a.m. CST",29085,28750,31520,2435
SOCO,"11/22/2024 9 a.m. CST",28548,28216,30858,2310
SOCO,"11/22/2024 10 a.m. CST",27869,27521,30093,2224
SOCO,"11/22/2024 11 a.m. CST",27355,26550,29431,2076
SOCO,"11/22/2024 12 p.m. CST",26528,25691,28808,2280
SOCO,"11/22/2024 1 p.m. CST",26244,25087,28683,2439
SOCO,"11/22/2024 2 p.m. CST",25802,24638,28375,2573
SOCO,"11/22/2024 3 p.m. CST",25216,24419,27622,2406
SOCO,"11/22/2024 4 p.m. CST",24961,24749,27374,2413
SOCO,"11/22/2024 5 p.m. CST",26009,25914,28296,2287
SOCO,"11/22/2024 6 p.m. CST",27285,27190,29092,1807
SOCO,"11/22/2024 7 p.m. CST",27399,27303,29037,1638
SOCO,"11/22/2024 8 p.m. CST",27401,27240,28819,1418
SOCO,"11/22/2024 9 p.m. CST",27034,26847,28861,1827
SOCO,"11/22/2024 10 p.m. CST",26365,26225,28183,1818
SOCO,"11/22/2024 11 p.m. CST",25726,25444,27264,1538
SOCO,"11/23/2024 12 a.m. CST",25073,24782,26568,1495
SOCO,"11/23/2024 1 a.m. CST",24484,24384,25638,1154
SOCO,"11/23/2024 2 a.m. CST",24039,24118,25003,964
SOCO,"11/23/2024 3 a.m. CST",23720,24001,24557,837
SOCO,"11/23/2024 4 a.m. CST",24084,24355,24870,786
SOCO,"11/23/2024 5 a.m. CST",24476,24980,25149,673
SOCO,"11/23/2024 6 a.m. CST",25405,25896,26463,1058
SOCO,"11/23/2024 7 a.m. CST",26111,26873,27140,1029
SOCO,"11/23/2024 8 a.m. CST",25276,27256,26596,1320
SOCO,"11/23/2024 9 a.m. CST",24126,26795,25419,1293
SOCO,"11/23/2024 10 a.m. CST",22949,25881,25113,2164
SOCO,"11/23/2024 11 a.m. CST",22559,24904,24704,2145
SOCO,"11/23/2024 12 p.m. CST",21489,23682,23714,2225
SOCO,"11/23/2024 1 p.m. CST",20740,22898,23031,2291
SOCO,"11/23/2024 2 p.m. CST",20566,22437,22896,2330
SOCO,"11/23/2024 3 p.m. CST",20539,22261,22903,2364
SOCO,"11/23/2024 4 p.m. CST",21323,22508,23736,2413
SOCO,"11/23/2024 5 p.m. CST",22779,23415,25348,2569
SOCO,"11/23/2024 6 p.m. CST",24045,24604,26685,2640
SOCO,"11/23/2024 7 p.m. CST",24120,24622,26511,2391
SOCO,"11/23/2024 8 p.m. CST",24103,24590,26281,2178
SOCO,"11/23/2024 9 p.m. CST",23980,24474,26138,2158
SOCO,"11/23/2024 10 p.m. CST",23466,24078,25732,2266
SOCO,"11/23/2024 11 p.m. CST",23107,23553,25124,2017
SOCO,"11/24/2024 12 a.m. CST",22516,22962,24641,2125
SOCO,"11/24/2024 1 a.m. CST",23180,22930,25037,1857
SOCO,"11/24/2024 2 a.m. CST",22801,22812,24544,1743
SOCO,"11/24/2024 3 a.m. CST",22753,22884,24472,1719
SOCO,"11/24/2024 4 a.m. CST",23139,23291,24840,1701
SOCO,"11/24/2024 5 a.m. CST",23921,23909,25453,1532
SOCO,"11/24/2024 6 a.m. CST",24880,24780,26643,1763
SOCO,"11/24/2024 7 a.m. CST",26077,25798,27784,1707
SOCO,"11/24/2024 8 a.m. CST",26775,26446,28534,1759
SOCO,"11/24/2024 9 a.m. CST",26050,25990,27528,1478
SOCO,"11/24/2024 10 a.m. CST",25318,24851,26767,1449
SOCO,"11/24/2024 11 a.m. CST",24112,23737,25718,1606
SOCO,"11/24/2024 12 p.m. CST",23376,22852,24993,1617
SOCO,"11/24/2024 1 p.m. CST",23344,22343,24788,1444
SOCO,"11/24/2024 2 p.m. CST",23091,22006,24495,1404
SOCO,"11/24/2024 3 p.m. CST",22735,21960,24451,1716
SOCO,"11/24/2024 4 p.m. CST",22851,22292,24497,1646
SOCO,"11/24/2024 5 p.m. CST",23306,23336,24670,1364
SOCO,"11/24/2024 6 p.m. CST",24430,24730,25723,1293
SOCO,"11/24/2024 7 p.m. CST",24582,24836,25716,1134
SOCO,"11/24/2024 8 p.m. CST",24242,24537,25443,1201
SOCO,"11/24/2024 9 p.m. CST",23756,23949,24791,1035
SOCO,"11/24/2024 10 p.m. CST",23079,23064,23904,825
SOCO,"11/24/2024 11 p.m. CST",22171,22086,23059,888
SOCO,"11/25/2024 12 a.m. CST",21906,21295,22560,654
SOCO,"11/25/2024 1 a.m. CST",21555,21097,22009,454
SOCO,"11/25/2024 2 a.m. CST",21452,20989,21814,362
SOCO,"11/25/2024 3 a.m. CST",21688,21213,21989,301
SOCO,"11/25/2024 4 a.m. CST",21862,21749,21994,132
SOCO,"11/25/2024 5 a.m. CST",22852,22709,23271,419
SOCO,"11/25/2024 6 a.m. CST",24403,24225,25287,884
SOCO,"11/25/2024 7 a.m. CST",25623,25426,26583,960
SOCO,"11/25/2024 8 a.m. CST",26028,25792,26855,827
SOCO,"11/25/2024 9 a.m. CST",25679,25437,26398,719
SOCO,"11/25/2024 10 a.m. CST",25738,24979,26184,446
SOCO,"11/25/2024 11 a.m. CST",25273,24479,25984,711
SOCO,"11/25/2024 12 p.m. CST",25003,24248,25799,796
SOCO,"11/25/2024 1 p.m. CST",25036,24269,25937,901
SOCO,"11/25/2024 2 p.m. CST",24963,24222,25823,860
SOCO,"11/25/2024 3 p.m. CST",24734,24149,25667,933
SOCO,"11/25/2024 4 p.m. CST",24672,24218,25297,625
SOCO,"11/25/2024 5 p.m. CST",24691,24599,25713,1022
SOCO,"11/25/2024 6 p.m. CST",25404,25287,26699,1295
SOCO,"11/25/2024 7 p.m. CST",25160,25001,26319,1159
SOCO,"11/25/2024 8 p.m. CST",24747,24579,25881,1134
SOCO,"11/25/2024 9 p.m. CST",23928,23776,25007,1079
SOCO,"11/25/2024 10 p.m. CST",22788,22654,23575,787
SOCO,"11/25/2024 11 p.m. CST",21589,21415,22384,795
SOCO,"11/26/2024 12 a.m. CST",20568,20434,21395,827
SOCO,"11/26/2024 1 a.m. CST",20613,19688,20987,374
SOCO,"11/26/2024 2 a.m. CST",20284,19248,20719,435
SOCO,"11/26/2024 3 a.m. CST",20171,19137,20456,285
SOCO,"11/26/2024 4 a.m. CST",20401,19355,20663,262
SOCO,"11/26/2024 5 a.m. CST",20838,20138,21083,245
SOCO,"11/26/2024 6 a.m. CST",21466,21343,21962,496
SOCO,"11/26/2024 7 a.m. CST",22679,22556,23095,416
SOCO,"11/26/2024 8 a.m. CST",23398,23257,23883,485
SOCO,"11/26/2024 9 a.m. CST",23969,23779,24428,459
SOCO,"11/26/2024 10 a.m. CST",24492,24082,24915,423
SOCO,"11/26/2024 11 a.m. CST",24856,24252,25120,264
SOCO,"11/26/2024 12 p.m. CST",24638,24252,25068,430
SOCO,"11/26/2024 1 p.m. CST",24364,24150,24983,619
SOCO,"11/26/2024 2 p.m. CST",24337,24127,25099,762
SOCO,"11/26/2024 3 p.m. CST",24122,23940,25078,956
SOCO,"11/26/2024 4 p.m. CST",23976,23829,24972,996
SOCO,"11/26/2024 5 p.m. CST",24547,24382,25882,1335
SOCO,"11/26/2024 6 p.m. CST",25353,25175,26721,1368
SOCO,"11/26/2024 7 p.m. CST",25437,25200,26791,1354
SOCO,"11/26/2024 8 p.m. CST",25348,24960,26852,1504
SOCO,"11/26/2024 9 p.m. CST",24837,24455,26264,1427
SOCO,"11/26/2024 10 p.m. CST",23959,23578,25219,1260
SOCO,"11/26/2024 11 p.m. CST",22907,22549,23994,1087
SOCO,"11/27/2024 12 a.m. CST",22058,21576,23184,1126
SOCO,"11/27/2024 1 a.m. CST",21990,21315,23261,1271
SOCO,"11/27/2024 2 a.m. CST",22110,21058,23415,1305
SOCO,"11/27/2024 3 a.m. CST",22166,21149,23468,1302
SOCO,"11/27/2024 4 a.m. CST",22663,21715,23946,1283
SOCO,"11/27/2024 5 a.m. CST",23091,22686,24434,1343
SOCO,"11/27/2024 6 a.m. CST",24551,24245,25978,1427
SOCO,"11/27/2024 7 a.m. CST",25855,25679,27565,1710
SOCO,"11/27/2024 8 a.m. CST",26694,26463,28248,1554
SOCO,"11/27/2024 9 a.m. CST",26512,26220,28177,1665
SOCO,"11/27/2024 10 a.m. CST",26110,25806,27225,1115
SOCO,"11/27/2024 11 a.m. CST",25868,25311,26748,880
SOCO,"11/27/2024 12 p.m. CST",25549,24867,26448,899
SOCO,"11/27/2024 1 p.m. CST",25535,24461,26457,922
SOCO,"11/27/2024 2 p.m. CST",25320,24157,26360,1040
SOCO,"11/27/2024 3 p.m. CST",24856,23956,25780,924
SOCO,"11/27/2024 4 p.m. CST",24223,23979,25096,873
SOCO,"11/27/2024 5 p.m. CST",24804,24630,25826,1022
SOCO,"11/27/2024 6 p.m. CST",25296,25142,26391,1095
SOCO,"11/27/2024 7 p.m. CST",25118,24926,25856,738
SOCO,"11/27/2024 8 p.m. CST",24804,24569,25447,643
SOCO,"11/27/2024 9 p.m. CST",24167,24215,25071,904
SOCO,"11/27/2024 10 p.m. CST",23247,23000,24017,770
SOCO,"11/27/2024 11 p.m. CST",22012,21681,22649,637
SOCO,"11/28/2024 12 a.m. CST",20881,20668,21411,530
SOCO,"11/28/2024 1 a.m. CST",20213,19661,20343,130
SOCO,"11/28/2024 2 a.m. CST",19873,18994,19966,93
SOCO,"11/28/2024 3 a.m. CST",19568,18599,19617,49
SOCO,"11/28/2024 4 a.m. CST",19382,18378,19509,127
SOCO,"11/28/2024 5 a.m. CST",19143,18511,19347,204
SOCO,"11/28/2024 6 a.m. CST",19555,18939,19842,287
SOCO,"11/28/2024 7 a.m. CST",19867,19615,20446,579
SOCO,"11/28/2024 8 a.m. CST",20988,20816,21711,723
SOCO,"11/28/2024 9 a.m. CST",22488,22251,23476,988
SOCO,"11/28/2024 10 a.m. CST",23700,23442,24839,1139
SOCO,"11/28/2024 11 a.m. CST",24153,23910,25325,1172
SOCO,"11/28/2024 12 p.m. CST",23882,23628,25141,1259
SOCO,"11/28/2024 1 p.m. CST",23159,22917,24602,1443
SOCO,"11/28/2024 2 p.m. CST",22483,22270,23825,1342
SOCO,"11/28/2024 3 p.m. CST",21837,21654,23199,1362
SOCO,"11/28/2024 4 p.m. CST",21344,21121,22799,1455
SOCO,"11/28/2024 5 p.m. CST",21452,21344,23068,1616
SOCO,"11/28/2024 6 p.m. CST",21767,21652,23137,1370
SOCO,"11/28/2024 7 p.m. CST",21749,21555,22913,1164
SOCO,"11/28/2024 8 p.m. CST",21835,21617,22763,928
SOCO,"11/28/2024 9 p.m. CST",21750,21594,22453,703
SOCO,"11/28/2024 10 p.m. CST",21439,21307,22230,791
SOCO,"11/28/2024 11 p.m. CST",21025,20887,21597,572
SOCO,"11/29/2024 12 a.m. CST",20507,20379,21150,643
SOCO,"11/29/2024 1 a.m. CST",20596,20116,21347,751
SOCO,"11/29/2024 2 a.m. CST",20533,19990,21297,764
SOCO,"11/29/2024 3 a.m. CST",20704,20191,21410,706
SOCO,"11/29/2024 4 a.m. CST",21173,20655,21854,681
SOCO,"11/29/2024 5 a.m. CST",21717,21531,22765,1048
SOCO,"11/29/2024 6 a.m. CST",22754,22579,24177,1423
SOCO,"11/29/2024 7 a.m. CST",23911,23791,25568,1657
SOCO,"11/29/2024 8 a.m. CST",24916,24728,26468,1552
SOCO,"11/29/2024 9 a.m. CST",25595,25354,27287,1692
SOCO,"11/29/2024 10 a.m. CST",25687,25448,27467,1780
SOCO,"11/29/2024 11 a.m. CST",25399,25082,27177,1778
SOCO,"11/29/2024 12 p.m. CST",25100,24473,26812,1712
SOCO,"11/29/2024 1 p.m. CST",24487,23800,26088,1601
SOCO,"11/29/2024 2 p.m. CST",24288,23292,25961,1673
SOCO,"11/29/2024 3 p.m. CST",23873,23221,25654,1781
SOCO,"11/29/2024 4 p.m. CST",23995,23755,25636,1641
SOCO,"11/29/2024 5 p.m. CST",25407,25261,27218,1811
SOCO,"11/29/2024 6 p.m. CST",26834,26705,28946,2112
SOCO,"11/29/2024 7 p.m. CST",27375,27247,29300,1925
SOCO,"11/29/2024 8 p.m. CST",27609,27412,29159,1550
SOCO,"11/29/2024 9 p.m. CST",27731,27504,29205,1474
SOCO,"11/29/2024 10 p.m. CST",27451,27209,28861,1410
SOCO,"11/29/2024 11 p.m. CST",27203,26877,28161,958
SOCO,"11/30/2024 12 a.m. CST",26886,26495,27770,884
SOCO,"11/30/2024 1 a.m. CST",26971,26232,28173,1202
SOCO,"11/30/2024 2 a.m. CST",26801,26277,28119,1318
SOCO,"11/30/2024 3 a.m. CST",27039,26683,28187,1148
SOCO,"11/30/2024 4 a.m. CST",27588,27215,28555,967
SOCO,"11/30/2024 5 a.m. CST",28408,28064,29256,848
SOCO,"11/30/2024 6 a.m. CST",29570,29214,30414,844
SOCO,"11/30/2024 7 a.m. CST",30688,30342,31609,921
SOCO,"11/30/2024 8 a.m. CST",31331,30874,32540,1209
SOCO,"11/30/2024 9 a.m. CST",30617,30117,32092,1475
SOCO,"11/30/2024 10 a.m. CST",29969,28882,31500,1531
SOCO,"11/30/2024 11 a.m. CST",28833,27551,30372,1539
SOCO,"11/30/2024 12 p.m. CST",27557,26307,29140,1583
SOCO,"11/30/2024 1 p.m. CST",26420,25168,27937,1517
SOCO,"11/30/2024 2 p.m. CST",25803,24390,27387,1584
SOCO,"11/30/2024 3 p.m. CST",24961,23954,26710,1749
SOCO,"11/30/2024 4 p.m. CST",25104,24322,26986,1882
SOCO,"11/30/2024 5 p.m. CST",25850,25708,27675,1825
SOCO,"11/30/2024 6 p.m. CST",27544,27425,29486,1942
SOCO,"11/30/2024 7 p.m. CST",28363,28224,30308,1945
SOCO,"11/30/2024 8 p.m. CST",28838,28716,30707,1869
SOCO,"11/30/2024 9 p.m. CST",29136,28983,30904,1768
SOCO,"11/30/2024 10 p.m. CST",28979,28834,30685,1706
SOCO,"11/30/2024 11 p.m. CST",28685,28539,30228,1543
SOCO,"12/1/2024 12 a.m. CST",28395,28040,29821,1426
