"BA Code","Timestamp (Hour Ending)","Demand (MWh)","Demand Forecast (MWh)","Net Generation (MWh)","Total Interchange (MWh)"
SOCO,"4/1/2024 12 a.m. CDT",19554,18977,20195,641
SOCO,"4/1/2024 1 a.m. CDT",18831,17981,19479,648
SOCO,"4/1/2024 2 a.m. CDT",18431,17512,19105,674
SOCO,"4/1/2024 3 a.m. CDT",18190,17253,18818,628
SOCO,"4/1/2024 4 a.m. CDT",17980,17513,18705,725
SOCO,"4/1/2024 5 a.m. CDT",18494,18279,19274,780
SOCO,"4/1/2024 6 a.m. CDT",19851,19636,20660,809
SOCO,"4/1/2024 7 a.m. CDT",21322,21169,22639,1317
SOCO,"4/1/2024 8 a.m. CDT",22185,21970,23756,1571
SOCO,"4/1/2024 9 a.m. CDT",22940,22703,24486,1546
SOCO,"4/1/2024 10 a.m. CDT",23615,23354,25439,1824
SOCO,"4/1/2024 11 a.m. CDT",24256,23948,26083,1827
SOCO,"4/1/2024 12 p.m. CDT",24657,24350,26453,1796
SOCO,"4/1/2024 1 p.m. CDT",25228,24921,27141,1913
SOCO,"4/1/2024 2 p.m. CDT",25577,25305,27199,1622
SOCO,"4/1/2024 3 p.m. CDT",25770,25453,27742,1972
SOCO,"4/1/2024 4 p.m. CDT",25914,25615,28043,2129
SOCO,"4/1/2024 5 p.m. CDT",26054,25776,28062,2008
SOCO,"4/1/2024 6 p.m. CDT",25975,25703,27822,1847
SOCO,"4/1/2024 7 p.m. CDT",25997,25818,27515,1518
SOCO,"4/1/2024 8 p.m. CDT",26387,26172,27804,1417
SOCO,"4/1/2024 9 p.m. CDT",25743,25544,27199,1456
SOCO,"4/1/2024 10 p.m. CDT",24417,24169,25574,1157
SOCO,"4/1/2024 11 p.m. CDT",23214,22489,23916,702
SOCO,"4/2/2024 12 a.m. CDT",22108,21026,22771,663
SOCO,"4/2/2024 1 a.m. CDT",21164,19923,21558,394
SOCO,"4/2/2024 2 a.m. CDT",20675,19288,21337,662
SOCO,"4/2/2024 3 a.m. CDT",20391,19035,20865,474
SOCO,"4/2/2024 4 a.m. CDT",20217,18978,20679,462
SOCO,"4/2/2024 5 a.m. CDT",20470,19538,21092,622
SOCO,"4/2/2024 6 a.m. CDT",21219,20824,22138,919
SOCO,"4/2/2024 7 a.m. CDT",22428,22210,23659,1231
SOCO,"4/2/2024 8 a.m. CDT",23056,22860,24573,1517
SOCO,"4/2/2024 9 a.m. CDT",23733,23514,25441,1708
SOCO,"4/2/2024 10 a.m. CDT",24409,24160,25788,1379
SOCO,"4/2/2024 11 a.m. CDT",25158,24885,26493,1335
SOCO,"4/2/2024 12 p.m. CDT",25793,25456,27242,1449
SOCO,"4/2/2024 1 p.m. CDT",26361,26088,27679,1318
SOCO,"4/2/2024 2 p.m. CDT",26991,26731,28275,1284
SOCO,"4/2/2024 3 p.m. CDT",27379,27163,28767,1388
SOCO,"4/2/2024 4 p.m. CDT",27614,27358,28840,1226
SOCO,"4/2/2024 5 p.m. CDT",27477,27249,28746,1269
SOCO,"4/2/2024 6 p.m. CDT",27362,27101,28957,1595
SOCO,"4/2/2024 7 p.m. CDT",27351,27206,28904,1553
SOCO,"4/2/2024 8 p.m. CDT",27493,27345,29027,1534
SOCO,"4/2/2024 9 p.m. CDT",26892,26675,28458,1566
SOCO,"4/2/2024 10 p.m. CDT",25370,25139,26600,1230
SOCO,"4/2/2024 11 p.m. CDT",24097,23552,25229,1132
SOCO,"4/3/2024 12 a.m. CDT",22876,21976,23736,860
SOCO,"4/3/2024 1 a.m. CDT",22169,20955,22955,786
SOCO,"4/3/2024 2 a.m. CDT",21545,20131,22282,737
SOCO,"4/3/2024 3 a.m. CDT",21116,19695,21734,618
SOCO,"4/3/2024 4 a.m. CDT",20796,19581,21650,854
SOCO,"4/3/2024 5 a.m. CDT",20866,19935,21806,940
SOCO,"4/3/2024 6 a.m. CDT",21649,20947,22661,1012
SOCO,"4/3/2024 7 a.m. CDT",22215,22049,23523,1308
SOCO,"4/3/2024 8 a.m. CDT",22535,22372,23864,1329
SOCO,"4/3/2024 9 a.m. CDT",22998,22875,24644,1646
SOCO,"4/3/2024 10 a.m. CDT",23358,23233,24960,1602
SOCO,"4/3/2024 11 a.m. CDT",23482,23356,25160,1678
SOCO,"4/3/2024 12 p.m. CDT",23441,23328,25124,1683
SOCO,"4/3/2024 1 p.m. CDT",23840,23349,25555,1715
SOCO,"4/3/2024 2 p.m. CDT",23946,23352,25776,1830
SOCO,"4/3/2024 3 p.m. CDT",23945,23324,25699,1754
SOCO,"4/3/2024 4 p.m. CDT",23917,23272,25753,1836
SOCO,"4/3/2024 5 p.m. CDT",23842,23317,26047,2205
SOCO,"4/3/2024 6 p.m. CDT",23400,23129,25363,1963
SOCO,"4/3/2024 7 p.m. CDT",23347,23162,25068,1721
SOCO,"4/3/2024 8 p.m. CDT",23967,23790,25882,1915
SOCO,"4/3/2024 9 p.m. CDT",23707,23534,25490,1783
SOCO,"4/3/2024 10 p.m. CDT",22669,22461,24287,1618
SOCO,"4/3/2024 11 p.m. CDT",21433,21114,22518,1085
SOCO,"4/4/2024 12 a.m. CDT",20790,20108,21669,879
SOCO,"4/4/2024 1 a.m. CDT",20249,19519,21263,1014
SOCO,"4/4/2024 2 a.m. CDT",20316,19247,21246,930
SOCO,"4/4/2024 3 a.m. CDT",20227,19178,21015,788
SOCO,"4/4/2024 4 a.m. CDT",20109,19539,21126,1017
SOCO,"4/4/2024 5 a.m. CDT",20819,20491,21863,1044
SOCO,"4/4/2024 6 a.m. CDT",22621,22285,23894,1273
SOCO,"4/4/2024 7 a.m. CDT",24583,24280,26081,1498
SOCO,"4/4/2024 8 a.m. CDT",25249,24853,27014,1765
SOCO,"4/4/2024 9 a.m. CDT",25171,24756,26797,1626
SOCO,"4/4/2024 10 a.m. CDT",24841,24440,26402,1561
SOCO,"4/4/2024 11 a.m. CDT",24426,24027,25988,1562
SOCO,"4/4/2024 12 p.m. CDT",23949,23548,25774,1825
SOCO,"4/4/2024 1 p.m. CDT",23983,23218,25547,1564
SOCO,"4/4/2024 2 p.m. CDT",23777,23039,25281,1504
SOCO,"4/4/2024 3 p.m. CDT",23551,22813,25106,1555
SOCO,"4/4/2024 4 p.m. CDT",23526,22775,25096,1570
SOCO,"4/4/2024 5 p.m. CDT",23303,22849,24858,1555
SOCO,"4/4/2024 6 p.m. CDT",23106,22879,24245,1139
SOCO,"4/4/2024 7 p.m. CDT",23356,23168,24382,1026
SOCO,"4/4/2024 8 p.m. CDT",24049,23921,24964,915
SOCO,"4/4/2024 9 p.m. CDT",24029,23933,25244,1215
SOCO,"4/4/2024 10 p.m. CDT",22950,22738,24000,1050
SOCO,"4/4/2024 11 p.m. CDT",21791,21625,22506,715
SOCO,"4/5/2024 12 a.m. CDT",21045,20754,21547,502
SOCO,"4/5/2024 1 a.m. CDT",21008,20153,21516,508
SOCO,"4/5/2024 2 a.m. CDT",20821,19893,21184,363
SOCO,"4/5/2024 3 a.m. CDT",20898,19969,21160,262
SOCO,"4/5/2024 4 a.m. CDT",20874,20398,21199,325
SOCO,"4/5/2024 5 a.m. CDT",21545,21377,21871,326
SOCO,"4/5/2024 6 a.m. CDT",23238,23079,23706,468
SOCO,"4/5/2024 7 a.m. CDT",24944,24805,25368,424
SOCO,"4/5/2024 8 a.m. CDT",25463,25227,25986,523
SOCO,"4/5/2024 9 a.m. CDT",25203,24969,26267,1064
SOCO,"4/5/2024 10 a.m. CDT",24636,24391,25764,1128
SOCO,"4/5/2024 11 a.m. CDT",24173,23839,25340,1167
SOCO,"4/5/2024 12 p.m. CDT",24093,23414,25084,991
SOCO,"4/5/2024 1 p.m. CDT",23739,23096,24639,900
SOCO,"4/5/2024 2 p.m. CDT",23904,22879,24912,1008
SOCO,"4/5/2024 3 p.m. CDT",23676,22662,24751,1075
SOCO,"4/5/2024 4 p.m. CDT",23557,22580,24945,1388
SOCO,"4/5/2024 5 p.m. CDT",23245,22617,24835,1590
SOCO,"4/5/2024 6 p.m. CDT",23162,22543,24672,1510
SOCO,"4/5/2024 7 p.m. CDT",22709,22524,24052,1343
SOCO,"4/5/2024 8 p.m. CDT",23207,23021,24356,1149
SOCO,"4/5/2024 9 p.m. CDT",23006,22787,23853,847
SOCO,"4/5/2024 10 p.m. CDT",22265,22069,22824,559
SOCO,"4/5/2024 11 p.m. CDT",21424,21232,21851,427
SOCO,"4/6/2024 12 a.m. CDT",20618,20448,21249,631
SOCO,"4/6/2024 1 a.m. CDT",20102,19912,21110,1008
SOCO,"4/6/2024 2 a.m. CDT",19899,19712,20966,1067
SOCO,"4/6/2024 3 a.m. CDT",19935,19766,20981,1046
SOCO,"4/6/2024 4 a.m. CDT",20251,20062,21331,1080
SOCO,"4/6/2024 5 a.m. CDT",20857,20677,22026,1169
SOCO,"4/6/2024 6 a.m. CDT",21879,21706,23025,1146
SOCO,"4/6/2024 7 a.m. CDT",23019,22830,24042,1023
SOCO,"4/6/2024 8 a.m. CDT",23904,23662,24989,1085
SOCO,"4/6/2024 9 a.m. CDT",23971,23694,25416,1445
SOCO,"4/6/2024 10 a.m. CDT",23588,23340,25218,1630
SOCO,"4/6/2024 11 a.m. CDT",22964,22676,24716,1752
SOCO,"4/6/2024 12 p.m. CDT",22683,22038,24492,1809
SOCO,"4/6/2024 1 p.m. CDT",22391,21533,24197,1806
SOCO,"4/6/2024 2 p.m. CDT",22257,21251,24321,2064
SOCO,"4/6/2024 3 p.m. CDT",21799,21047,23909,2110
SOCO,"4/6/2024 4 p.m. CDT",21730,21119,24011,2281
SOCO,"4/6/2024 5 p.m. CDT",21958,21375,24102,2144
SOCO,"4/6/2024 6 p.m. CDT",21668,21444,23306,1638
SOCO,"4/6/2024 7 p.m. CDT",21625,21456,22999,1374
SOCO,"4/6/2024 8 p.m. CDT",22229,22103,23633,1404
SOCO,"4/6/2024 9 p.m. CDT",22051,21901,23477,1426
SOCO,"4/6/2024 10 p.m. CDT",21516,21291,22908,1392
SOCO,"4/6/2024 11 p.m. CDT",20687,20494,21802,1115
SOCO,"4/7/2024 12 a.m. CDT",20020,19832,21200,1180
SOCO,"4/7/2024 1 a.m. CDT",19544,19374,20381,837
SOCO,"4/7/2024 2 a.m. CDT",19345,19162,20211,866
SOCO,"4/7/2024 3 a.m. CDT",19412,19247,20594,1182
SOCO,"4/7/2024 4 a.m. CDT",19945,19419,20964,1019
SOCO,"4/7/2024 5 a.m. CDT",20461,19962,21563,1102
SOCO,"4/7/2024 6 a.m. CDT",20881,20728,22001,1120
SOCO,"4/7/2024 7 a.m. CDT",21706,21584,23194,1488
SOCO,"4/7/2024 8 a.m. CDT",22585,22379,24189,1604
SOCO,"4/7/2024 9 a.m. CDT",22730,22398,24571,1841
SOCO,"4/7/2024 10 a.m. CDT",22290,21928,23780,1490
SOCO,"4/7/2024 11 a.m. CDT",22090,21499,23368,1278
SOCO,"4/7/2024 12 p.m. CDT",22161,21266,23534,1373
SOCO,"4/7/2024 1 p.m. CDT",22220,21246,23721,1501
SOCO,"4/7/2024 2 p.m. CDT",22216,21455,23734,1518
SOCO,"4/7/2024 3 p.m. CDT",22266,21638,23768,1502
SOCO,"4/7/2024 4 p.m. CDT",22377,22134,23906,1529
SOCO,"4/7/2024 5 p.m. CDT",22900,22681,24543,1643
SOCO,"4/7/2024 6 p.m. CDT",23335,23136,24680,1345
SOCO,"4/7/2024 7 p.m. CDT",23322,23203,24775,1453
SOCO,"4/7/2024 8 p.m. CDT",23864,23697,25027,1163
SOCO,"4/7/2024 9 p.m. CDT",23407,23258,24570,1163
SOCO,"4/7/2024 10 p.m. CDT",22048,21871,22966,918
SOCO,"4/7/2024 11 p.m. CDT",20472,20313,21162,690
SOCO,"4/8/2024 12 a.m. CDT",19752,19201,20333,581
SOCO,"4/8/2024 1 a.m. CDT",19475,18427,20338,863
SOCO,"4/8/2024 2 a.m. CDT",19079,17988,20014,935
SOCO,"4/8/2024 3 a.m. CDT",18915,17835,19919,1004
SOCO,"4/8/2024 4 a.m. CDT",19092,18186,20221,1129
SOCO,"4/8/2024 5 a.m. CDT",19359,19185,20365,1006
SOCO,"4/8/2024 6 a.m. CDT",21289,21117,22353,1064
SOCO,"4/8/2024 7 a.m. CDT",22838,22658,23881,1043
SOCO,"4/8/2024 8 a.m. CDT",23124,22917,24162,1038
SOCO,"4/8/2024 9 a.m. CDT",23281,23031,24597,1316
SOCO,"4/8/2024 10 a.m. CDT",23611,23235,24970,1359
SOCO,"4/8/2024 11 a.m. CDT",23846,23478,25275,1429
SOCO,"4/8/2024 12 p.m. CDT",24287,23843,25654,1367
SOCO,"4/8/2024 1 p.m. CDT",24911,24281,26272,1361
SOCO,"4/8/2024 2 p.m. CDT",24976,24592,26258,1282
SOCO,"4/8/2024 3 p.m. CDT",24456,24209,25916,1460
SOCO,"4/8/2024 4 p.m. CDT",24632,24366,26192,1560
SOCO,"4/8/2024 5 p.m. CDT",24966,24715,26281,1315
SOCO,"4/8/2024 6 p.m. CDT",25056,24877,26463,1407
SOCO,"4/8/2024 7 p.m. CDT",25118,24970,26283,1165
SOCO,"4/8/2024 8 p.m. CDT",25526,25430,26397,871
SOCO,"4/8/2024 9 p.m. CDT",24844,24724,25511,667
SOCO,"4/8/2024 10 p.m. CDT",23354,23175,24264,910
SOCO,"4/8/2024 11 p.m. CDT",21685,21509,22716,1031
SOCO,"4/9/2024 12 a.m. CDT",20666,20125,21454,788
SOCO,"4/9/2024 1 a.m. CDT",19938,19205,20598,660
SOCO,"4/9/2024 2 a.m. CDT",19471,18550,20038,567
SOCO,"4/9/2024 3 a.m. CDT",19233,18304,19755,522
SOCO,"4/9/2024 4 a.m. CDT",19196,18494,19703,507
SOCO,"4/9/2024 5 a.m. CDT",19837,19300,20448,611
SOCO,"4/9/2024 6 a.m. CDT",21244,20999,21682,438
SOCO,"4/9/2024 7 a.m. CDT",22533,22372,23215,682
SOCO,"4/9/2024 8 a.m. CDT",23007,22822,23948,941
SOCO,"4/9/2024 9 a.m. CDT",23489,23156,24290,801
SOCO,"4/9/2024 10 a.m. CDT",23912,23575,24600,688
SOCO,"4/9/2024 11 a.m. CDT",24279,23831,24937,658
SOCO,"4/9/2024 12 p.m. CDT",24640,24022,25195,555
SOCO,"4/9/2024 1 p.m. CDT",24581,24186,25308,727
SOCO,"4/9/2024 2 p.m. CDT",24644,24254,25432,788
SOCO,"4/9/2024 3 p.m. CDT",24566,24192,25457,891
SOCO,"4/9/2024 4 p.m. CDT",24595,24225,25235,640
SOCO,"4/9/2024 5 p.m. CDT",24611,24428,25420,809
SOCO,"4/9/2024 6 p.m. CDT",24759,24567,25443,684
SOCO,"4/9/2024 7 p.m. CDT",24884,24785,25481,597
SOCO,"4/9/2024 8 p.m. CDT",25322,25234,25873,551
SOCO,"4/9/2024 9 p.m. CDT",24693,24602,25353,660
SOCO,"4/9/2024 10 p.m. CDT",23205,22999,23991,786
SOCO,"4/9/2024 11 p.m. CDT",21685,21506,22362,677
SOCO,"4/10/2024 12 a.m. CDT",20778,19675,21730,952
SOCO,"4/10/2024 1 a.m. CDT",20594,19689,21454,860
SOCO,"4/10/2024 2 a.m. CDT",20066,19171,21111,1045
SOCO,"4/10/2024 3 a.m. CDT",19812,18902,20851,1039
SOCO,"4/10/2024 4 a.m. CDT",19956,19087,20997,1041
SOCO,"4/10/2024 5 a.m. CDT",20442,19890,21251,809
SOCO,"4/10/2024 6 a.m. CDT",21883,21580,22546,663
SOCO,"4/10/2024 7 a.m. CDT",23038,22785,24072,1034
SOCO,"4/10/2024 8 a.m. CDT",23546,23243,24627,1081
SOCO,"4/10/2024 9 a.m. CDT",23862,23524,25149,1287
SOCO,"4/10/2024 10 a.m. CDT",24084,23719,25391,1307
SOCO,"4/10/2024 11 a.m. CDT",24408,24027,25524,1116
SOCO,"4/10/2024 12 p.m. CDT",24481,24105,25683,1202
SOCO,"4/10/2024 1 p.m. CDT",24682,24338,25836,1154
SOCO,"4/10/2024 2 p.m. CDT",24812,24450,26065,1253
SOCO,"4/10/2024 3 p.m. CDT",24782,24452,25934,1152
SOCO,"4/10/2024 4 p.m. CDT",24874,24523,25859,985
SOCO,"4/10/2024 5 p.m. CDT",24735,24555,25907,1172
SOCO,"4/10/2024 6 p.m. CDT",24813,24627,25798,985
SOCO,"4/10/2024 7 p.m. CDT",24928,24804,26064,1136
SOCO,"4/10/2024 8 p.m. CDT",25039,24937,26165,1126
SOCO,"4/10/2024 9 p.m. CDT",24327,24199,25436,1109
SOCO,"4/10/2024 10 p.m. CDT",22934,22753,24253,1319
SOCO,"4/10/2024 11 p.m. CDT",21464,21318,22839,1375
SOCO,"4/11/2024 12 a.m. CDT",20235,20111,21497,1262
SOCO,"4/11/2024 1 a.m. CDT",19761,19278,20251,490
SOCO,"4/11/2024 2 a.m. CDT",19390,18870,19854,464
SOCO,"4/11/2024 3 a.m. CDT",19135,18655,19512,377
SOCO,"4/11/2024 4 a.m. CDT",19343,18861,19603,260
SOCO,"4/11/2024 5 a.m. CDT",20122,19630,20509,387
SOCO,"4/11/2024 6 a.m. CDT",21290,21183,21501,211
SOCO,"4/11/2024 7 a.m. CDT",22676,22543,23008,332
SOCO,"4/11/2024 8 a.m. CDT",23074,22939,23503,429
SOCO,"4/11/2024 9 a.m. CDT",23637,23511,24669,1032
SOCO,"4/11/2024 10 a.m. CDT",24060,23946,25327,1267
SOCO,"4/11/2024 11 a.m. CDT",24405,24238,25851,1446
SOCO,"4/11/2024 12 p.m. CDT",24620,24448,26064,1444
SOCO,"4/11/2024 1 p.m. CDT",24829,24651,26126,1297
SOCO,"4/11/2024 2 p.m. CDT",25017,24847,26511,1494
SOCO,"4/11/2024 3 p.m. CDT",24920,24768,26352,1432
SOCO,"4/11/2024 4 p.m. CDT",24898,24718,26349,1451
SOCO,"4/11/2024 5 p.m. CDT",24669,24469,26192,1523
SOCO,"4/11/2024 6 p.m. CDT",24498,24319,26018,1520
SOCO,"4/11/2024 7 p.m. CDT",24429,24261,25642,1213
SOCO,"4/11/2024 8 p.m. CDT",24656,24561,25788,1132
SOCO,"4/11/2024 9 p.m. CDT",24084,23899,24971,887
SOCO,"4/11/2024 10 p.m. CDT",22828,22669,24051,1223
SOCO,"4/11/2024 11 p.m. CDT",21286,21090,22252,966
SOCO,"4/12/2024 12 a.m. CDT",19868,19883,20736,868
SOCO,"4/12/2024 1 a.m. CDT",19521,19151,20721,1200
SOCO,"4/12/2024 2 a.m. CDT",19066,18696,20265,1199
SOCO,"4/12/2024 3 a.m. CDT",18998,18653,20268,1270
SOCO,"4/12/2024 4 a.m. CDT",19167,18795,20250,1083
SOCO,"4/12/2024 5 a.m. CDT",20059,19751,21103,1044
SOCO,"4/12/2024 6 a.m. CDT",21633,21630,22479,846
SOCO,"4/12/2024 7 a.m. CDT",22768,22950,23864,1096
SOCO,"4/12/2024 8 a.m. CDT",22093,23304,23475,1382
SOCO,"4/12/2024 9 a.m. CDT",21458,23378,22976,1518
SOCO,"4/12/2024 10 a.m. CDT",21206,23341,22698,1492
SOCO,"4/12/2024 11 a.m. CDT",21045,23249,22557,1512
SOCO,"4/12/2024 12 p.m. CDT",21274,22998,22874,1600
SOCO,"4/12/2024 1 p.m. CDT",20981,22872,22535,1554
SOCO,"4/12/2024 2 p.m. CDT",20902,22762,22477,1575
SOCO,"4/12/2024 3 p.m. CDT",20839,22664,22287,1448
SOCO,"4/12/2024 4 p.m. CDT",21107,22838,22545,1438
SOCO,"4/12/2024 5 p.m. CDT",21348,22918,22697,1349
SOCO,"4/12/2024 6 p.m. CDT",21356,22756,22540,1184
SOCO,"4/12/2024 7 p.m. CDT",22260,22560,23087,827
SOCO,"4/12/2024 8 p.m. CDT",22898,22888,23643,745
SOCO,"4/12/2024 9 p.m. CDT",22721,22696,23386,665
SOCO,"4/12/2024 10 p.m. CDT",21893,21861,22637,744
SOCO,"4/12/2024 11 p.m. CDT",20775,20755,21691,916
SOCO,"4/13/2024 12 a.m. CDT",19826,19822,20662,836
SOCO,"4/13/2024 1 a.m. CDT",19523,19134,20286,763
SOCO,"4/13/2024 2 a.m. CDT",19072,18701,19843,771
SOCO,"4/13/2024 3 a.m. CDT",19018,18624,19823,805
SOCO,"4/13/2024 4 a.m. CDT",18736,18732,19558,822
SOCO,"4/13/2024 5 a.m. CDT",19293,19268,20033,740
SOCO,"4/13/2024 6 a.m. CDT",20120,20133,20947,827
SOCO,"4/13/2024 7 a.m. CDT",20814,20990,21598,784
SOCO,"4/13/2024 8 a.m. CDT",20792,21875,21846,1054
SOCO,"4/13/2024 9 a.m. CDT",20422,22119,21692,1270
SOCO,"4/13/2024 10 a.m. CDT",20378,21869,21477,1099
SOCO,"4/13/2024 11 a.m. CDT",20048,21625,21192,1144
SOCO,"4/13/2024 12 p.m. CDT",19815,21423,21005,1190
SOCO,"4/13/2024 1 p.m. CDT",19871,21450,21057,1186
SOCO,"4/13/2024 2 p.m. CDT",20019,21600,21277,1258
SOCO,"4/13/2024 3 p.m. CDT",20458,22005,21643,1185
SOCO,"4/13/2024 4 p.m. CDT",20628,22534,21703,1075
SOCO,"4/13/2024 5 p.m. CDT",21301,23084,22279,978
SOCO,"4/13/2024 6 p.m. CDT",21988,23231,22741,753
SOCO,"4/13/2024 7 p.m. CDT",22613,22924,23430,817
SOCO,"4/13/2024 8 p.m. CDT",22747,22765,23121,374
SOCO,"4/13/2024 9 p.m. CDT",22222,22259,22741,519
SOCO,"4/13/2024 10 p.m. CDT",21152,21194,21547,395
SOCO,"4/13/2024 11 p.m. CDT",20001,19970,20690,689
SOCO,"4/14/2024 12 a.m. CDT",18803,18793,19664,861
SOCO,"4/14/2024 1 a.m. CDT",18252,17880,19112,860
SOCO,"4/14/2024 2 a.m. CDT",17776,17406,18521,745
SOCO,"4/14/2024 3 a.m. CDT",17504,17142,18278,774
SOCO,"4/14/2024 4 a.m. CDT",17293,17148,18143,850
SOCO,"4/14/2024 5 a.m. CDT",17438,17458,18282,844
SOCO,"4/14/2024 6 a.m. CDT",17943,17965,18812,869
SOCO,"4/14/2024 7 a.m. CDT",18426,18591,19430,1004
SOCO,"4/14/2024 8 a.m. CDT",18896,19547,20189,1293
SOCO,"4/14/2024 9 a.m. CDT",19086,20334,20368,1282
SOCO,"4/14/2024 10 a.m. CDT",19258,20718,20660,1402
SOCO,"4/14/2024 11 a.m. CDT",19592,21131,21088,1496
SOCO,"4/14/2024 12 p.m. CDT",20243,21788,21732,1489
SOCO,"4/14/2024 1 p.m. CDT",20898,22713,22163,1265
SOCO,"4/14/2024 2 p.m. CDT",21820,23615,23110,1290
SOCO,"4/14/2024 3 p.m. CDT",22662,24523,23736,1074
SOCO,"4/14/2024 4 p.m. CDT",23656,25420,24504,848
SOCO,"4/14/2024 5 p.m. CDT",24464,26066,25490,1026
SOCO,"4/14/2024 6 p.m. CDT",24997,26071,26099,1102
SOCO,"4/14/2024 7 p.m. CDT",25483,25718,26462,979
SOCO,"4/14/2024 8 p.m. CDT",25661,25744,26469,808
SOCO,"4/14/2024 9 p.m. CDT",25045,25101,25891,846
SOCO,"4/14/2024 10 p.m. CDT",23416,23435,24260,844
SOCO,"4/14/2024 11 p.m. CDT",21494,21480,22061,567
SOCO,"4/15/2024 12 a.m. CDT",19988,19838,20708,720
SOCO,"4/15/2024 1 a.m. CDT",19429,18781,20408,979
SOCO,"4/15/2024 2 a.m. CDT",19078,18051,19894,816
SOCO,"4/15/2024 3 a.m. CDT",18702,17673,19557,855
SOCO,"4/15/2024 4 a.m. CDT",18867,17843,19684,817
SOCO,"4/15/2024 5 a.m. CDT",19706,18669,20487,781
SOCO,"4/15/2024 6 a.m. CDT",20664,20308,21678,1014
SOCO,"4/15/2024 7 a.m. CDT",21768,21569,23206,1438
SOCO,"4/15/2024 8 a.m. CDT",22369,22138,23983,1614
SOCO,"4/15/2024 9 a.m. CDT",23359,22745,24972,1613
SOCO,"4/15/2024 10 a.m. CDT",23908,23507,25827,1919
SOCO,"4/15/2024 11 a.m. CDT",24644,24342,26721,2077
SOCO,"4/15/2024 12 p.m. CDT",25691,25362,27531,1840
SOCO,"4/15/2024 1 p.m. CDT",26900,26590,28948,2048
SOCO,"4/15/2024 2 p.m. CDT",28064,27788,29958,1894
SOCO,"4/15/2024 3 p.m. CDT",29101,28808,30970,1869
SOCO,"4/15/2024 4 p.m. CDT",29906,29651,31850,1944
SOCO,"4/15/2024 5 p.m. CDT",30326,30122,32223,1897
SOCO,"4/15/2024 6 p.m. CDT",30179,30025,31959,1780
SOCO,"4/15/2024 7 p.m. CDT",29440,29346,31017,1577
SOCO,"4/15/2024 8 p.m. CDT",28844,28733,30395,1551
SOCO,"4/15/2024 9 p.m. CDT",27604,27540,29278,1674
SOCO,"4/15/2024 10 p.m. CDT",25396,25214,27134,1738
SOCO,"4/15/2024 11 p.m. CDT",23195,22983,24437,1242
SOCO,"4/16/2024 12 a.m. CDT",21413,21223,22622,1209
SOCO,"4/16/2024 1 a.m. CDT",20756,19972,22097,1341
SOCO,"4/16/2024 2 a.m. CDT",20340,19258,21727,1387
SOCO,"4/16/2024 3 a.m. CDT",19818,18754,21174,1356
SOCO,"4/16/2024 4 a.m. CDT",19774,18706,21105,1331
SOCO,"4/16/2024 5 a.m. CDT",20476,19446,21708,1232
SOCO,"4/16/2024 6 a.m. CDT",21305,21059,22501,1196
SOCO,"4/16/2024 7 a.m. CDT",22422,22215,24303,1881
SOCO,"4/16/2024 8 a.m. CDT",22935,22685,24983,2048
SOCO,"4/16/2024 9 a.m. CDT",23900,23248,25749,1849
SOCO,"4/16/2024 10 a.m. CDT",24514,23866,26370,1856
SOCO,"4/16/2024 11 a.m. CDT",25209,24539,27042,1833
SOCO,"4/16/2024 12 p.m. CDT",25799,25462,27611,1812
SOCO,"4/16/2024 1 p.m. CDT",26885,26576,28521,1636
SOCO,"4/16/2024 2 p.m. CDT",27998,27748,29553,1555
SOCO,"4/16/2024 3 p.m. CDT",29057,28745,30621,1564
SOCO,"4/16/2024 4 p.m. CDT",29816,29516,31564,1748
SOCO,"4/16/2024 5 p.m. CDT",30175,29986,31977,1802
SOCO,"4/16/2024 6 p.m. CDT",29893,29693,31211,1318
SOCO,"4/16/2024 7 p.m. CDT",29154,28974,29994,840
SOCO,"4/16/2024 8 p.m. CDT",28822,28642,29685,863
SOCO,"4/16/2024 9 p.m. CDT",27756,27568,29244,1488
SOCO,"4/16/2024 10 p.m. CDT",25716,25499,27579,1863
SOCO,"4/16/2024 11 p.m. CDT",23656,23450,25463,1807
SOCO,"4/17/2024 12 a.m. CDT",22313,21726,23947,1634
SOCO,"4/17/2024 1 a.m. CDT",21679,20597,23200,1521
SOCO,"4/17/2024 2 a.m. CDT",20934,19845,22468,1534
SOCO,"4/17/2024 3 a.m. CDT",20492,19399,22094,1602
SOCO,"4/17/2024 4 a.m. CDT",20430,19386,21936,1506
SOCO,"4/17/2024 5 a.m. CDT",20847,20146,22464,1617
SOCO,"4/17/2024 6 a.m. CDT",22377,21730,23819,1442
SOCO,"4/17/2024 7 a.m. CDT",23001,22810,24769,1768
SOCO,"4/17/2024 8 a.m. CDT",23457,23271,25149,1692
SOCO,"4/17/2024 9 a.m. CDT",24071,23871,25858,1787
SOCO,"4/17/2024 10 a.m. CDT",24796,24580,26576,1780
SOCO,"4/17/2024 11 a.m. CDT",25547,25292,27301,1754
SOCO,"4/17/2024 12 p.m. CDT",26476,26107,28159,1683
SOCO,"4/17/2024 1 p.m. CDT",27351,27134,28931,1580
SOCO,"4/17/2024 2 p.m. CDT",27969,27680,29233,1264
SOCO,"4/17/2024 3 p.m. CDT",28302,28061,29554,1252
SOCO,"4/17/2024 4 p.m. CDT",28476,28329,29828,1352
SOCO,"4/17/2024 5 p.m. CDT",28485,28412,29917,1432
SOCO,"4/17/2024 6 p.m. CDT",28047,27947,29275,1228
SOCO,"4/17/2024 7 p.m. CDT",27705,27594,28725,1020
SOCO,"4/17/2024 8 p.m. CDT",27746,27655,28574,828
SOCO,"4/17/2024 9 p.m. CDT",27039,26834,28011,972
SOCO,"4/17/2024 10 p.m. CDT",25355,25148,26442,1087
SOCO,"4/17/2024 11 p.m. CDT",23772,23287,24828,1056
SOCO,"4/18/2024 12 a.m. CDT",22515,21727,23584,1069
SOCO,"4/18/2024 1 a.m. CDT",21412,20579,22588,1176
SOCO,"4/18/2024 2 a.m. CDT",20625,19825,21735,1110
SOCO,"4/18/2024 3 a.m. CDT",20171,19383,21249,1078
SOCO,"4/18/2024 4 a.m. CDT",20214,19414,21260,1046
SOCO,"4/18/2024 5 a.m. CDT",20932,20127,22095,1163
SOCO,"4/18/2024 6 a.m. CDT",22198,21664,23646,1448
SOCO,"4/18/2024 7 a.m. CDT",23361,22790,24758,1397
SOCO,"4/18/2024 8 a.m. CDT",23558,23369,25127,1569
SOCO,"4/18/2024 9 a.m. CDT",24228,24087,26182,1954
SOCO,"4/18/2024 10 a.m. CDT",25323,25134,27153,1830
SOCO,"4/18/2024 11 a.m. CDT",26436,26242,28054,1618
SOCO,"4/18/2024 12 p.m. CDT",27618,27370,29325,1707
SOCO,"4/18/2024 1 p.m. CDT",28858,28589,30475,1617
SOCO,"4/18/2024 2 p.m. CDT",30028,29743,31810,1782
SOCO,"4/18/2024 3 p.m. CDT",30980,30665,32663,1683
SOCO,"4/18/2024 4 p.m. CDT",31712,31427,33580,1868
SOCO,"4/18/2024 5 p.m. CDT",31927,31654,33784,1857
SOCO,"4/18/2024 6 p.m. CDT",31348,31092,33137,1789
SOCO,"4/18/2024 7 p.m. CDT",30505,30344,32224,1719
SOCO,"4/18/2024 8 p.m. CDT",30064,29842,31362,1298
SOCO,"4/18/2024 9 p.m. CDT",29090,28859,30267,1177
SOCO,"4/18/2024 10 p.m. CDT",27154,26938,27986,832
SOCO,"4/18/2024 11 p.m. CDT",25219,24751,25707,488
SOCO,"4/19/2024 12 a.m. CDT",23672,22999,23913,241
SOCO,"4/19/2024 1 a.m. CDT",22985,21743,23196,211
SOCO,"4/19/2024 2 a.m. CDT",22109,20883,22444,335
SOCO,"4/19/2024 3 a.m. CDT",21575,20356,21915,340
SOCO,"4/19/2024 4 a.m. CDT",21516,20278,21848,332
SOCO,"4/19/2024 5 a.m. CDT",21734,20814,22085,351
SOCO,"4/19/2024 6 a.m. CDT",22872,22199,23213,341
SOCO,"4/19/2024 7 a.m. CDT",23926,23249,24366,440
SOCO,"4/19/2024 8 a.m. CDT",24472,23791,25076,604
SOCO,"4/19/2024 9 a.m. CDT",25336,24654,25940,604
SOCO,"4/19/2024 10 a.m. CDT",26248,25886,26922,674
SOCO,"4/19/2024 11 a.m. CDT",27583,27189,28085,502
SOCO,"4/19/2024 12 p.m. CDT",28714,28191,29256,542
SOCO,"4/19/2024 1 p.m. CDT",29970,29393,30205,235
SOCO,"4/19/2024 2 p.m. CDT",31118,30508,31354,236
SOCO,"4/19/2024 3 p.m. CDT",31890,31447,32385,495
SOCO,"4/19/2024 4 p.m. CDT",32599,32145,33270,671
SOCO,"4/19/2024 5 p.m. CDT",32727,32281,33355,628
SOCO,"4/19/2024 6 p.m. CDT",32038,31674,32614,576
SOCO,"4/19/2024 7 p.m. CDT",30751,30495,31284,533
SOCO,"4/19/2024 8 p.m. CDT",29810,29570,30239,429
SOCO,"4/19/2024 9 p.m. CDT",28840,28599,28910,70
SOCO,"4/19/2024 10 p.m. CDT",27254,26898,27345,91
SOCO,"4/19/2024 11 p.m. CDT",25295,24966,25243,-52
SOCO,"4/20/2024 12 a.m. CDT",23554,23070,23402,-152
SOCO,"4/20/2024 1 a.m. CDT",22479,21611,22490,11
SOCO,"4/20/2024 2 a.m. CDT",21362,20446,21487,125
SOCO,"4/20/2024 3 a.m. CDT",20659,19764,20885,226
SOCO,"4/20/2024 4 a.m. CDT",20277,19361,20632,355
SOCO,"4/20/2024 5 a.m. CDT",20495,19362,21031,536
SOCO,"4/20/2024 6 a.m. CDT",20807,19679,21409,602
SOCO,"4/20/2024 7 a.m. CDT",21024,20025,21908,884
SOCO,"4/20/2024 8 a.m. CDT",21784,21214,22652,868
SOCO,"4/20/2024 9 a.m. CDT",23143,22537,23907,764
SOCO,"4/20/2024 10 a.m. CDT",24539,23899,25183,644
SOCO,"4/20/2024 11 a.m. CDT",25684,24982,26017,333
SOCO,"4/20/2024 12 p.m. CDT",26710,26030,27045,335
SOCO,"4/20/2024 1 p.m. CDT",27439,27075,27985,546
SOCO,"4/20/2024 2 p.m. CDT",28268,27900,28814,546
SOCO,"4/20/2024 3 p.m. CDT",28675,28342,29501,826
SOCO,"4/20/2024 4 p.m. CDT",28703,28348,29582,879
SOCO,"4/20/2024 5 p.m. CDT",28540,28225,29049,509
SOCO,"4/20/2024 6 p.m. CDT",27598,27318,28020,422
SOCO,"4/20/2024 7 p.m. CDT",26346,26140,26852,506
SOCO,"4/20/2024 8 p.m. CDT",25927,25752,26795,868
SOCO,"4/20/2024 9 p.m. CDT",24989,24795,25846,857
SOCO,"4/20/2024 10 p.m. CDT",23762,23421,24281,519
SOCO,"4/20/2024 11 p.m. CDT",22264,21939,22807,543
SOCO,"4/21/2024 12 a.m. CDT",21078,20754,21846,768
SOCO,"4/21/2024 1 a.m. CDT",19921,19208,20889,968
SOCO,"4/21/2024 2 a.m. CDT",19067,18383,20097,1030
SOCO,"4/21/2024 3 a.m. CDT",19039,17977,19970,931
SOCO,"4/21/2024 4 a.m. CDT",18738,17694,19782,1044
SOCO,"4/21/2024 5 a.m. CDT",18695,17629,19742,1047
SOCO,"4/21/2024 6 a.m. CDT",18844,17905,19898,1054
SOCO,"4/21/2024 7 a.m. CDT",19240,18390,20431,1191
SOCO,"4/21/2024 8 a.m. CDT",19906,19310,20974,1068
SOCO,"4/21/2024 9 a.m. CDT",21273,20512,22268,995
SOCO,"4/21/2024 10 a.m. CDT",22004,21249,22995,991
SOCO,"4/21/2024 11 a.m. CDT",22309,21715,23268,959
SOCO,"4/21/2024 12 p.m. CDT",22370,21968,23495,1125
SOCO,"4/21/2024 1 p.m. CDT",22495,22093,23867,1372
SOCO,"4/21/2024 2 p.m. CDT",22387,21974,23680,1293
SOCO,"4/21/2024 3 p.m. CDT",22338,21816,23740,1402
SOCO,"4/21/2024 4 p.m. CDT",22382,21785,24048,1666
SOCO,"4/21/2024 5 p.m. CDT",22555,21997,24386,1831
SOCO,"4/21/2024 6 p.m. CDT",22643,22103,24499,1856
SOCO,"4/21/2024 7 p.m. CDT",22791,22248,24581,1790
SOCO,"4/21/2024 8 p.m. CDT",23362,22917,24841,1479
SOCO,"4/21/2024 9 p.m. CDT",23225,22817,24447,1222
SOCO,"4/21/2024 10 p.m. CDT",22292,21793,23223,931
SOCO,"4/21/2024 11 p.m. CDT",20883,20377,21916,1033
SOCO,"4/22/2024 12 a.m. CDT",20166,19323,21123,957
SOCO,"4/22/2024 1 a.m. CDT",19512,18575,20312,800
SOCO,"4/22/2024 2 a.m. CDT",19290,18349,20128,838
SOCO,"4/22/2024 3 a.m. CDT",19289,18347,20052,763
SOCO,"4/22/2024 4 a.m. CDT",19366,18798,20236,870
SOCO,"4/22/2024 5 a.m. CDT",20221,19990,21000,779
SOCO,"4/22/2024 6 a.m. CDT",22380,22158,22947,567
SOCO,"4/22/2024 7 a.m. CDT",24117,23881,24894,777
SOCO,"4/22/2024 8 a.m. CDT",24531,24281,25405,874
SOCO,"4/22/2024 9 a.m. CDT",24512,24224,25214,702
SOCO,"4/22/2024 10 a.m. CDT",24206,23883,25023,817
SOCO,"4/22/2024 11 a.m. CDT",24386,23702,25385,999
SOCO,"4/22/2024 12 p.m. CDT",24134,23454,25262,1128
SOCO,"4/22/2024 1 p.m. CDT",24041,23360,25221,1180
SOCO,"4/22/2024 2 p.m. CDT",23933,23223,25065,1132
SOCO,"4/22/2024 3 p.m. CDT",23793,23178,24931,1138
SOCO,"4/22/2024 4 p.m. CDT",23703,23384,24904,1201
SOCO,"4/22/2024 5 p.m. CDT",23937,23612,25126,1189
SOCO,"4/22/2024 6 p.m. CDT",24026,23726,25201,1175
SOCO,"4/22/2024 7 p.m. CDT",24072,23853,24895,823
SOCO,"4/22/2024 8 p.m. CDT",24411,24290,25045,634
SOCO,"4/22/2024 9 p.m. CDT",24129,24015,24585,456
SOCO,"4/22/2024 10 p.m. CDT",22734,22511,23252,518
SOCO,"4/22/2024 11 p.m. CDT",21248,21067,22043,795
SOCO,"4/23/2024 12 a.m. CDT",20210,19972,21296,1086
SOCO,"4/23/2024 1 a.m. CDT",19951,19416,20862,911
SOCO,"4/23/2024 2 a.m. CDT",19898,19208,20721,823
SOCO,"4/23/2024 3 a.m. CDT",19951,19246,20828,877
SOCO,"4/23/2024 4 a.m. CDT",20412,19768,21312,900
SOCO,"4/23/2024 5 a.m. CDT",21576,20982,22343,767
SOCO,"4/23/2024 6 a.m. CDT",23490,23245,24195,705
SOCO,"4/23/2024 7 a.m. CDT",24951,24703,25365,414
SOCO,"4/23/2024 8 a.m. CDT",25031,24740,25682,651
SOCO,"4/23/2024 9 a.m. CDT",24582,24277,25394,812
SOCO,"4/23/2024 10 a.m. CDT",24467,23798,25531,1064
SOCO,"4/23/2024 11 a.m. CDT",24220,23556,25397,1177
SOCO,"4/23/2024 12 p.m. CDT",24071,23390,25332,1261
SOCO,"4/23/2024 1 p.m. CDT",24025,23352,25278,1253
SOCO,"4/23/2024 2 p.m. CDT",24191,23480,25603,1412
SOCO,"4/23/2024 3 p.m. CDT",24441,23735,26189,1748
SOCO,"4/23/2024 4 p.m. CDT",24775,24114,26707,1932
SOCO,"4/23/2024 5 p.m. CDT",24802,24469,26627,1825
SOCO,"4/23/2024 6 p.m. CDT",24799,24475,26269,1470
SOCO,"4/23/2024 7 p.m. CDT",24678,24398,25772,1094
SOCO,"4/23/2024 8 p.m. CDT",24791,24603,25612,821
SOCO,"4/23/2024 9 p.m. CDT",24374,24211,25172,798
SOCO,"4/23/2024 10 p.m. CDT",22890,22684,23839,949
SOCO,"4/23/2024 11 p.m. CDT",21133,20919,22128,995
SOCO,"4/24/2024 12 a.m. CDT",19858,19593,20612,754
SOCO,"4/24/2024 1 a.m. CDT",19517,18851,20543,1026
SOCO,"4/24/2024 2 a.m. CDT",19050,18393,20103,1053
SOCO,"4/24/2024 3 a.m. CDT",18960,18300,19991,1031
SOCO,"4/24/2024 4 a.m. CDT",19175,18539,20329,1154
SOCO,"4/24/2024 5 a.m. CDT",19998,19468,20796,798
SOCO,"4/24/2024 6 a.m. CDT",21580,21357,22291,711
SOCO,"4/24/2024 7 a.m. CDT",22843,22601,23779,936
SOCO,"4/24/2024 8 a.m. CDT",23093,22813,23844,751
SOCO,"4/24/2024 9 a.m. CDT",23633,22987,24846,1213
SOCO,"4/24/2024 10 a.m. CDT",23816,23166,25433,1617
SOCO,"4/24/2024 11 a.m. CDT",23971,23213,25555,1584
SOCO,"4/24/2024 12 p.m. CDT",24278,23571,25817,1539
SOCO,"4/24/2024 1 p.m. CDT",24853,24199,26411,1558
SOCO,"4/24/2024 2 p.m. CDT",25125,24672,26617,1492
SOCO,"4/24/2024 3 p.m. CDT",25432,25126,27126,1694
SOCO,"4/24/2024 4 p.m. CDT",25760,25477,27397,1637
SOCO,"4/24/2024 5 p.m. CDT",26140,25860,27446,1306
SOCO,"4/24/2024 6 p.m. CDT",26124,25856,27180,1056
SOCO,"4/24/2024 7 p.m. CDT",25895,25753,27004,1109
SOCO,"4/24/2024 8 p.m. CDT",25819,25680,26702,883
SOCO,"4/24/2024 9 p.m. CDT",25430,25246,26326,896
SOCO,"4/24/2024 10 p.m. CDT",23791,23560,24639,848
SOCO,"4/24/2024 11 p.m. CDT",21912,21704,22801,889
SOCO,"4/25/2024 12 a.m. CDT",20391,20191,21279,888
SOCO,"4/25/2024 1 a.m. CDT",19826,19168,20660,834
SOCO,"4/25/2024 2 a.m. CDT",19263,18590,20464,1201
SOCO,"4/25/2024 3 a.m. CDT",19054,18400,20388,1334
SOCO,"4/25/2024 4 a.m. CDT",19244,18510,20621,1377
SOCO,"4/25/2024 5 a.m. CDT",20292,19397,21409,1117
SOCO,"4/25/2024 6 a.m. CDT",21204,21043,22463,1259
SOCO,"4/25/2024 7 a.m. CDT",22382,22208,23613,1231
SOCO,"4/25/2024 8 a.m. CDT",22926,22723,24434,1508
SOCO,"4/25/2024 9 a.m. CDT",23741,23143,25043,1302
SOCO,"4/25/2024 10 a.m. CDT",24351,23752,25352,1001
SOCO,"4/25/2024 11 a.m. CDT",25097,24459,25789,692
SOCO,"4/25/2024 12 p.m. CDT",25831,25205,26513,682
SOCO,"4/25/2024 1 p.m. CDT",26282,25995,27058,776
SOCO,"4/25/2024 2 p.m. CDT",27049,26759,27648,599
SOCO,"4/25/2024 3 p.m. CDT",27863,27542,28442,579
SOCO,"4/25/2024 4 p.m. CDT",28262,27954,28958,696
SOCO,"4/25/2024 5 p.m. CDT",28417,28116,29039,622
SOCO,"4/25/2024 6 p.m. CDT",28109,27868,28417,308
SOCO,"4/25/2024 7 p.m. CDT",27594,27403,27603,9
SOCO,"4/25/2024 8 p.m. CDT",27255,27064,27360,105
SOCO,"4/25/2024 9 p.m. CDT",26483,26320,26793,310
SOCO,"4/25/2024 10 p.m. CDT",24619,24382,24684,65
SOCO,"4/25/2024 11 p.m. CDT",22637,22425,22752,115
SOCO,"4/26/2024 12 a.m. CDT",20734,20796,21216,482
SOCO,"4/26/2024 1 a.m. CDT",20490,19591,21074,584
SOCO,"4/26/2024 2 a.m. CDT",20076,18951,20820,744
SOCO,"4/26/2024 3 a.m. CDT",19664,18514,20479,815
SOCO,"4/26/2024 4 a.m. CDT",19801,18675,20600,799
SOCO,"4/26/2024 5 a.m. CDT",20243,19301,21062,819
SOCO,"4/26/2024 6 a.m. CDT",21043,20750,21888,845
SOCO,"4/26/2024 7 a.m. CDT",22048,21802,23418,1370
SOCO,"4/26/2024 8 a.m. CDT",22610,22433,24029,1419
SOCO,"4/26/2024 9 a.m. CDT",23364,23212,25009,1645
SOCO,"4/26/2024 10 a.m. CDT",24173,24031,26000,1827
SOCO,"4/26/2024 11 a.m. CDT",25414,24892,26782,1368
SOCO,"4/26/2024 12 p.m. CDT",26370,25792,27637,1267
SOCO,"4/26/2024 1 p.m. CDT",26988,26719,28243,1255
SOCO,"4/26/2024 2 p.m. CDT",27707,27457,28855,1148
SOCO,"4/26/2024 3 p.m. CDT",28275,27964,29489,1214
SOCO,"4/26/2024 4 p.m. CDT",28870,28598,30116,1246
SOCO,"4/26/2024 5 p.m. CDT",28932,28657,30045,1113
SOCO,"4/26/2024 6 p.m. CDT",28254,27941,29198,944
SOCO,"4/26/2024 7 p.m. CDT",27410,27125,28543,1133
SOCO,"4/26/2024 8 p.m. CDT",26847,26544,28313,1466
SOCO,"4/26/2024 9 p.m. CDT",26221,25904,27429,1208
SOCO,"4/26/2024 10 p.m. CDT",24775,24432,25984,1209
SOCO,"4/26/2024 11 p.m. CDT",23107,22762,24385,1278
SOCO,"4/27/2024 12 a.m. CDT",21599,21253,22972,1373
SOCO,"4/27/2024 1 a.m. CDT",20608,19966,21316,708
SOCO,"4/27/2024 2 a.m. CDT",19816,19075,20695,879
SOCO,"4/27/2024 3 a.m. CDT",19301,18569,20368,1067
SOCO,"4/27/2024 4 a.m. CDT",19073,18340,20159,1086
SOCO,"4/27/2024 5 a.m. CDT",19160,18460,20175,1015
SOCO,"4/27/2024 6 a.m. CDT",19363,18802,20404,1041
SOCO,"4/27/2024 7 a.m. CDT",19954,19243,20834,880
SOCO,"4/27/2024 8 a.m. CDT",21082,20318,21945,863
SOCO,"4/27/2024 9 a.m. CDT",22179,21401,23428,1249
SOCO,"4/27/2024 10 a.m. CDT",23206,22390,24465,1259
SOCO,"4/27/2024 11 a.m. CDT",24038,23180,25297,1259
SOCO,"4/27/2024 12 p.m. CDT",24370,23852,25801,1431
SOCO,"4/27/2024 1 p.m. CDT",24975,24477,26776,1801
SOCO,"4/27/2024 2 p.m. CDT",25377,24954,26992,1615
SOCO,"4/27/2024 3 p.m. CDT",25833,25399,27564,1731
SOCO,"4/27/2024 4 p.m. CDT",26107,25708,27808,1701
SOCO,"4/27/2024 5 p.m. CDT",26197,25814,27944,1747
SOCO,"4/27/2024 6 p.m. CDT",25869,25522,27546,1677
SOCO,"4/27/2024 7 p.m. CDT",25365,24978,26728,1363
SOCO,"4/27/2024 8 p.m. CDT",25067,24687,26607,1540
SOCO,"4/27/2024 9 p.m. CDT",24663,24307,26341,1678
SOCO,"4/27/2024 10 p.m. CDT",23482,23113,25103,1621
SOCO,"4/27/2024 11 p.m. CDT",22068,21698,23825,1757
SOCO,"4/28/2024 12 a.m. CDT",20757,20387,22560,1803
SOCO,"4/28/2024 1 a.m. CDT",19449,19247,20876,1427
SOCO,"4/28/2024 2 a.m. CDT",19053,18448,20567,1514
SOCO,"4/28/2024 3 a.m. CDT",18566,17920,20169,1603
SOCO,"4/28/2024 4 a.m. CDT",18296,17631,19840,1544
SOCO,"4/28/2024 5 a.m. CDT",18261,17573,19868,1607
SOCO,"4/28/2024 6 a.m. CDT",18509,17807,19981,1472
SOCO,"4/28/2024 7 a.m. CDT",18881,18142,20082,1201
SOCO,"4/28/2024 8 a.m. CDT",20184,19382,21554,1370
SOCO,"4/28/2024 9 a.m. CDT",21631,20769,23263,1632
SOCO,"4/28/2024 10 a.m. CDT",22705,21741,24529,1824
SOCO,"4/28/2024 11 a.m. CDT",23720,22766,25413,1693
SOCO,"4/28/2024 12 p.m. CDT",24350,23946,26034,1684
SOCO,"4/28/2024 1 p.m. CDT",25243,24862,26865,1622
SOCO,"4/28/2024 2 p.m. CDT",26035,25702,27861,1826
SOCO,"4/28/2024 3 p.m. CDT",26642,26320,28647,2005
SOCO,"4/28/2024 4 p.m. CDT",27094,26792,29002,1908
SOCO,"4/28/2024 5 p.m. CDT",27393,27118,29141,1748
SOCO,"4/28/2024 6 p.m. CDT",27209,26940,28890,1681
SOCO,"4/28/2024 7 p.m. CDT",26765,26530,28490,1725
SOCO,"4/28/2024 8 p.m. CDT",26484,26248,28252,1768
SOCO,"4/28/2024 9 p.m. CDT",25869,25651,27688,1819
SOCO,"4/28/2024 10 p.m. CDT",24181,23910,25819,1638
SOCO,"4/28/2024 11 p.m. CDT",22203,22424,23710,1507
SOCO,"4/29/2024 12 a.m. CDT",20869,20781,22315,1446
SOCO,"4/29/2024 1 a.m. CDT",19993,19171,21500,1507
SOCO,"4/29/2024 2 a.m. CDT",19551,18454,21263,1712
SOCO,"4/29/2024 3 a.m. CDT",19172,18129,21000,1828
SOCO,"4/29/2024 4 a.m. CDT",19171,18261,21046,1875
SOCO,"4/29/2024 5 a.m. CDT",19577,19019,21642,2065
SOCO,"4/29/2024 6 a.m. CDT",21022,20654,23321,2299
SOCO,"4/29/2024 7 a.m. CDT",22003,21805,24832,2829
SOCO,"4/29/2024 8 a.m. CDT",23019,22499,25890,2871
SOCO,"4/29/2024 9 a.m. CDT",23930,23323,26903,2973
SOCO,"4/29/2024 10 a.m. CDT",24871,24227,28129,3258
SOCO,"4/29/2024 11 a.m. CDT",25832,25117,28924,3092
SOCO,"4/29/2024 12 p.m. CDT",26463,26187,29437,2974
SOCO,"4/29/2024 1 p.m. CDT",27258,27020,30115,2857
SOCO,"4/29/2024 2 p.m. CDT",28019,27735,30790,2771
SOCO,"4/29/2024 3 p.m. CDT",28691,28384,31203,2512
SOCO,"4/29/2024 4 p.m. CDT",29131,28845,31442,2311
SOCO,"4/29/2024 5 p.m. CDT",29221,29041,31647,2426
SOCO,"4/29/2024 6 p.m. CDT",29005,28844,31322,2317
SOCO,"4/29/2024 7 p.m. CDT",28474,28331,30653,2179
SOCO,"4/29/2024 8 p.m. CDT",28123,28001,29897,1774
SOCO,"4/29/2024 9 p.m. CDT",27322,27204,29291,1969
SOCO,"4/29/2024 10 p.m. CDT",25393,25260,27552,2159
SOCO,"4/29/2024 11 p.m. CDT",23468,23209,24984,1516
SOCO,"4/30/2024 12 a.m. CDT",21802,21547,23220,1418
SOCO,"4/30/2024 1 a.m. CDT",21139,20415,22553,1414
SOCO,"4/30/2024 2 a.m. CDT",20420,19676,21917,1497
SOCO,"4/30/2024 3 a.m. CDT",19984,19252,21500,1516
SOCO,"4/30/2024 4 a.m. CDT",20038,19318,21598,1560
SOCO,"4/30/2024 5 a.m. CDT",20715,19979,22104,1389
SOCO,"4/30/2024 6 a.m. CDT",22276,21528,23562,1286
SOCO,"4/30/2024 7 a.m. CDT",23529,22757,25564,2035
SOCO,"4/30/2024 8 a.m. CDT",24064,23323,26539,2475
SOCO,"4/30/2024 9 a.m. CDT",24540,23918,27357,2817
SOCO,"4/30/2024 10 a.m. CDT",25106,24651,27902,2796
SOCO,"4/30/2024 11 a.m. CDT",25663,25339,28416,2753
SOCO,"4/30/2024 12 p.m. CDT",26259,25912,29122,2863
SOCO,"4/30/2024 1 p.m. CDT",27129,26764,29803,2674
SOCO,"4/30/2024 2 p.m. CDT",27992,27581,30768,2776
SOCO,"4/30/2024 3 p.m. CDT",28812,28485,31332,2520
SOCO,"4/30/2024 4 p.m. CDT",29472,29120,31627,2155
SOCO,"4/30/2024 5 p.m. CDT",29969,29640,32128,2159
SOCO,"4/30/2024 6 p.m. CDT",29939,29658,32163,2224
SOCO,"4/30/2024 7 p.m. CDT",29320,29137,31505,2185
SOCO,"4/30/2024 8 p.m. CDT",28690,28538,30417,1727
SOCO,"4/30/2024 9 p.m. CDT",27901,27748,29671,1770
SOCO,"4/30/2024 10 p.m. CDT",25859,25636,28030,2171
SOCO,"4/30/2024 11 p.m. CDT",23655,23484,25435,1780
SOCO,"5/1/2024 12 a.m. CDT",22297,21735,23865,1568
