"BA Code","Timestamp (Hour Ending)","Demand (MWh)","Demand Forecast (MWh)","Net Generation (MWh)","Total Interchange (MWh)"
SOCO,"7/1/2024 12 a.m. CDT",29590,29679,30775,1185
SOCO,"7/1/2024 1 a.m. CDT",27976,27891,28954,978
SOCO,"7/1/2024 2 a.m. CDT",26924,26552,27739,815
SOCO,"7/1/2024 3 a.m. CDT",26144,25748,27021,877
SOCO,"7/1/2024 4 a.m. CDT",25721,25328,26552,831
SOCO,"7/1/2024 5 a.m. CDT",26272,25647,27049,777
SOCO,"7/1/2024 6 a.m. CDT",26935,26299,27787,852
SOCO,"7/1/2024 7 a.m. CDT",27705,27379,28530,825
SOCO,"7/1/2024 8 a.m. CDT",29082,29304,29911,829
SOCO,"7/1/2024 9 a.m. CDT",30714,31684,31593,879
SOCO,"7/1/2024 10 a.m. CDT",32705,34482,33398,693
SOCO,"7/1/2024 11 a.m. CDT",35468,37345,36248,780
SOCO,"7/1/2024 12 p.m. CDT",37541,39563,38472,931
SOCO,"7/1/2024 1 p.m. CDT",39021,41233,39929,908
SOCO,"7/1/2024 2 p.m. CDT",39929,42190,40629,700
SOCO,"7/1/2024 3 p.m. CDT",40609,42811,41270,661
SOCO,"7/1/2024 4 p.m. CDT",41134,43251,41500,366
SOCO,"7/1/2024 5 p.m. CDT",41370,43179,41851,481
SOCO,"7/1/2024 6 p.m. CDT",40910,42433,41571,661
SOCO,"7/1/2024 7 p.m. CDT",40499,41199,41284,785
SOCO,"7/1/2024 8 p.m. CDT",39150,39484,39835,685
SOCO,"7/1/2024 9 p.m. CDT",37620,37903,38196,576
SOCO,"7/1/2024 10 p.m. CDT",35415,35539,35885,470
SOCO,"7/1/2024 11 p.m. CDT",33081,32979,33329,248
SOCO,"7/2/2024 12 a.m. CDT",30967,30612,31343,376
SOCO,"7/2/2024 1 a.m. CDT",29500,28712,29812,312
SOCO,"7/2/2024 2 a.m. CDT",28328,27408,28484,156
SOCO,"7/2/2024 3 a.m. CDT",27443,26533,27664,221
SOCO,"7/2/2024 4 a.m. CDT",27287,26139,27541,254
SOCO,"7/2/2024 5 a.m. CDT",27502,26301,27675,173
SOCO,"7/2/2024 6 a.m. CDT",28071,26885,27964,-107
SOCO,"7/2/2024 7 a.m. CDT",28396,27493,28685,289
SOCO,"7/2/2024 8 a.m. CDT",29007,28464,29687,680
SOCO,"7/2/2024 9 a.m. CDT",30351,29782,31714,1363
SOCO,"7/2/2024 10 a.m. CDT",31760,31462,33431,1671
SOCO,"7/2/2024 11 a.m. CDT",33680,33374,35579,1899
SOCO,"7/2/2024 12 p.m. CDT",35363,35002,36965,1602
SOCO,"7/2/2024 1 p.m. CDT",37070,36681,38869,1799
SOCO,"7/2/2024 2 p.m. CDT",38433,38034,40046,1613
SOCO,"7/2/2024 3 p.m. CDT",39459,39144,41052,1593
SOCO,"7/2/2024 4 p.m. CDT",40332,40061,42088,1756
SOCO,"7/2/2024 5 p.m. CDT",40532,40266,42569,2037
SOCO,"7/2/2024 6 p.m. CDT",40054,39815,41980,1926
SOCO,"7/2/2024 7 p.m. CDT",39085,38851,41065,1980
SOCO,"7/2/2024 8 p.m. CDT",37660,37102,39734,2074
SOCO,"7/2/2024 9 p.m. CDT",36395,35849,38188,1793
SOCO,"7/2/2024 10 p.m. CDT",34361,33823,35613,1252
SOCO,"7/2/2024 11 p.m. CDT",32008,31457,32914,906
SOCO,"7/3/2024 12 a.m. CDT",29899,29214,30579,680
SOCO,"7/3/2024 1 a.m. CDT",28424,27406,29061,637
SOCO,"7/3/2024 2 a.m. CDT",27145,26063,27745,600
SOCO,"7/3/2024 3 a.m. CDT",26377,25340,27145,768
SOCO,"7/3/2024 4 a.m. CDT",26435,25021,27253,818
SOCO,"7/3/2024 5 a.m. CDT",26859,25446,27515,656
SOCO,"7/3/2024 6 a.m. CDT",27506,26110,28221,715
SOCO,"7/3/2024 7 a.m. CDT",28235,26985,29227,992
SOCO,"7/3/2024 8 a.m. CDT",28852,28274,30794,1942
SOCO,"7/3/2024 9 a.m. CDT",30271,30011,32410,2139
SOCO,"7/3/2024 10 a.m. CDT",32421,32141,34637,2216
SOCO,"7/3/2024 11 a.m. CDT",34689,34349,36971,2282
SOCO,"7/3/2024 12 p.m. CDT",36839,36469,39379,2540
SOCO,"7/3/2024 1 p.m. CDT",38489,38289,40854,2365
SOCO,"7/3/2024 2 p.m. CDT",39857,39719,42139,2282
SOCO,"7/3/2024 3 p.m. CDT",40758,40608,43160,2402
SOCO,"7/3/2024 4 p.m. CDT",41356,41225,43867,2511
SOCO,"7/3/2024 5 p.m. CDT",41414,41308,44149,2735
SOCO,"7/3/2024 6 p.m. CDT",40848,40719,43493,2645
SOCO,"7/3/2024 7 p.m. CDT",39750,39658,42450,2700
SOCO,"7/3/2024 8 p.m. CDT",38053,37976,40541,2488
SOCO,"7/3/2024 9 p.m. CDT",36694,36538,38843,2149
SOCO,"7/3/2024 10 p.m. CDT",34737,34506,36923,2186
SOCO,"7/3/2024 11 p.m. CDT",32675,32149,34026,1351
SOCO,"7/4/2024 12 a.m. CDT",30780,29872,32077,1297
SOCO,"7/4/2024 1 a.m. CDT",28919,27960,30324,1405
SOCO,"7/4/2024 2 a.m. CDT",27601,26540,29015,1414
SOCO,"7/4/2024 3 a.m. CDT",26805,25523,28189,1384
SOCO,"7/4/2024 4 a.m. CDT",26217,24802,27628,1411
SOCO,"7/4/2024 5 a.m. CDT",25935,24521,27332,1397
SOCO,"7/4/2024 6 a.m. CDT",25506,24276,27041,1535
SOCO,"7/4/2024 7 a.m. CDT",25503,24431,27799,2296
SOCO,"7/4/2024 8 a.m. CDT",26617,25988,29144,2527
SOCO,"7/4/2024 9 a.m. CDT",28876,28580,31274,2398
SOCO,"7/4/2024 10 a.m. CDT",31889,31594,34088,2199
SOCO,"7/4/2024 11 a.m. CDT",34983,34646,37023,2040
SOCO,"7/4/2024 12 p.m. CDT",37245,36900,39553,2308
SOCO,"7/4/2024 1 p.m. CDT",38850,38656,41387,2537
SOCO,"7/4/2024 2 p.m. CDT",39856,39736,42639,2783
SOCO,"7/4/2024 3 p.m. CDT",40484,40298,43441,2957
SOCO,"7/4/2024 4 p.m. CDT",41029,40863,44202,3173
SOCO,"7/4/2024 5 p.m. CDT",40949,40873,43667,2718
SOCO,"7/4/2024 6 p.m. CDT",40225,40148,42716,2491
SOCO,"7/4/2024 7 p.m. CDT",38833,38782,40960,2127
SOCO,"7/4/2024 8 p.m. CDT",36986,36879,39210,2224
SOCO,"7/4/2024 9 p.m. CDT",35390,35262,37536,2146
SOCO,"7/4/2024 10 p.m. CDT",34169,33707,36042,1873
SOCO,"7/4/2024 11 p.m. CDT",32694,32200,34202,1508
SOCO,"7/5/2024 12 a.m. CDT",30903,30210,32170,1267
SOCO,"7/5/2024 1 a.m. CDT",28620,28417,29904,1284
SOCO,"7/5/2024 2 a.m. CDT",27181,26998,28457,1276
SOCO,"7/5/2024 3 a.m. CDT",26128,25960,27583,1455
SOCO,"7/5/2024 4 a.m. CDT",25602,25426,27069,1467
SOCO,"7/5/2024 5 a.m. CDT",25497,25336,26784,1287
SOCO,"7/5/2024 6 a.m. CDT",25679,25509,27074,1395
SOCO,"7/5/2024 7 a.m. CDT",26458,26264,28228,1770
SOCO,"7/5/2024 8 a.m. CDT",28476,28269,30263,1787
SOCO,"7/5/2024 9 a.m. CDT",31415,31167,33092,1677
SOCO,"7/5/2024 10 a.m. CDT",34575,34296,36125,1550
SOCO,"7/5/2024 11 a.m. CDT",37223,36943,38978,1755
SOCO,"7/5/2024 12 p.m. CDT",38937,38679,40817,1880
SOCO,"7/5/2024 1 p.m. CDT",39537,39341,41710,2173
SOCO,"7/5/2024 2 p.m. CDT",40100,39891,42096,1996
SOCO,"7/5/2024 3 p.m. CDT",40257,40092,42246,1989
SOCO,"7/5/2024 4 p.m. CDT",39630,39484,41941,2311
SOCO,"7/5/2024 5 p.m. CDT",38568,38441,40911,2343
SOCO,"7/5/2024 6 p.m. CDT",37396,37268,39841,2445
SOCO,"7/5/2024 7 p.m. CDT",36000,35894,38492,2492
SOCO,"7/5/2024 8 p.m. CDT",34546,34431,37205,2659
SOCO,"7/5/2024 9 p.m. CDT",33582,33534,36232,2650
SOCO,"7/5/2024 10 p.m. CDT",31890,31796,34255,2365
SOCO,"7/5/2024 11 p.m. CDT",30225,30086,32135,1910
SOCO,"7/6/2024 12 a.m. CDT",28468,28341,30247,1779
SOCO,"7/6/2024 1 a.m. CDT",26883,26737,28258,1375
SOCO,"7/6/2024 2 a.m. CDT",25687,25533,27080,1393
SOCO,"7/6/2024 3 a.m. CDT",24837,24685,26219,1382
SOCO,"7/6/2024 4 a.m. CDT",24334,24214,25781,1447
SOCO,"7/6/2024 5 a.m. CDT",24147,23995,26019,1872
SOCO,"7/6/2024 6 a.m. CDT",24053,23929,25918,1865
SOCO,"7/6/2024 7 a.m. CDT",24385,24218,26649,2264
SOCO,"7/6/2024 8 a.m. CDT",26116,25935,28616,2500
SOCO,"7/6/2024 9 a.m. CDT",28723,28503,31445,2722
SOCO,"7/6/2024 10 a.m. CDT",31873,31626,34310,2437
SOCO,"7/6/2024 11 a.m. CDT",34678,34440,36784,2106
SOCO,"7/6/2024 12 p.m. CDT",37158,36899,39078,1920
SOCO,"7/6/2024 1 p.m. CDT",38781,38516,40978,2197
SOCO,"7/6/2024 2 p.m. CDT",39803,39530,42029,2226
SOCO,"7/6/2024 3 p.m. CDT",39681,39399,42028,2347
SOCO,"7/6/2024 4 p.m. CDT",38634,38375,40990,2356
SOCO,"7/6/2024 5 p.m. CDT",37103,36834,39460,2357
SOCO,"7/6/2024 6 p.m. CDT",35720,35466,37992,2272
SOCO,"7/6/2024 7 p.m. CDT",34523,34306,36929,2406
SOCO,"7/6/2024 8 p.m. CDT",33303,33113,35928,2625
SOCO,"7/6/2024 9 p.m. CDT",32459,32302,34837,2378
SOCO,"7/6/2024 10 p.m. CDT",31037,30856,33247,2210
SOCO,"7/6/2024 11 p.m. CDT",29399,29201,31130,1731
SOCO,"7/7/2024 12 a.m. CDT",27634,27449,29033,1399
SOCO,"7/7/2024 1 a.m. CDT",26282,26089,27294,1012
SOCO,"7/7/2024 2 a.m. CDT",25039,24853,25943,904
SOCO,"7/7/2024 3 a.m. CDT",24280,24122,25307,1027
SOCO,"7/7/2024 4 a.m. CDT",23720,23563,24683,963
SOCO,"7/7/2024 5 a.m. CDT",23555,23391,24728,1173
SOCO,"7/7/2024 6 a.m. CDT",23465,23299,24662,1197
SOCO,"7/7/2024 7 a.m. CDT",23803,23634,25476,1673
SOCO,"7/7/2024 8 a.m. CDT",25461,25259,27201,1740
SOCO,"7/7/2024 9 a.m. CDT",27798,27570,29685,1887
SOCO,"7/7/2024 10 a.m. CDT",30571,30283,32923,2352
SOCO,"7/7/2024 11 a.m. CDT",33272,32963,35952,2680
SOCO,"7/7/2024 12 p.m. CDT",35806,35447,38213,2407
SOCO,"7/7/2024 1 p.m. CDT",37889,37520,40499,2610
SOCO,"7/7/2024 2 p.m. CDT",39282,38919,41806,2524
SOCO,"7/7/2024 3 p.m. CDT",40035,39654,42311,2276
SOCO,"7/7/2024 4 p.m. CDT",40560,40246,42729,2169
SOCO,"7/7/2024 5 p.m. CDT",40501,40216,42859,2358
SOCO,"7/7/2024 6 p.m. CDT",39943,39666,42223,2280
SOCO,"7/7/2024 7 p.m. CDT",38678,38406,40748,2070
SOCO,"7/7/2024 8 p.m. CDT",36831,36585,38952,2121
SOCO,"7/7/2024 9 p.m. CDT",35307,35082,37759,2452
SOCO,"7/7/2024 10 p.m. CDT",33110,32908,35436,2326
SOCO,"7/7/2024 11 p.m. CDT",30918,30678,32855,1937
SOCO,"7/8/2024 12 a.m. CDT",28851,28630,30629,1778
SOCO,"7/8/2024 1 a.m. CDT",27119,26924,28476,1357
SOCO,"7/8/2024 2 a.m. CDT",25997,25802,27373,1376
SOCO,"7/8/2024 3 a.m. CDT",25304,25127,26790,1486
SOCO,"7/8/2024 4 a.m. CDT",25109,24943,26585,1476
SOCO,"7/8/2024 5 a.m. CDT",25527,25328,27049,1522
SOCO,"7/8/2024 6 a.m. CDT",26329,26142,27752,1423
SOCO,"7/8/2024 7 a.m. CDT",27417,27224,29271,1854
SOCO,"7/8/2024 8 a.m. CDT",29166,28945,31122,1956
SOCO,"7/8/2024 9 a.m. CDT",31287,31033,33662,2375
SOCO,"7/8/2024 10 a.m. CDT",34025,33796,36425,2400
SOCO,"7/8/2024 11 a.m. CDT",36865,36545,39086,2221
SOCO,"7/8/2024 12 p.m. CDT",39202,38908,41514,2312
SOCO,"7/8/2024 1 p.m. CDT",41191,40876,43301,2110
SOCO,"7/8/2024 2 p.m. CDT",42648,42352,45376,2728
SOCO,"7/8/2024 3 p.m. CDT",43294,43055,46002,2708
SOCO,"7/8/2024 4 p.m. CDT",43517,43305,46393,2876
SOCO,"7/8/2024 5 p.m. CDT",42850,42676,45871,3021
SOCO,"7/8/2024 6 p.m. CDT",41497,41342,44657,3160
SOCO,"7/8/2024 7 p.m. CDT",40085,39931,42886,2801
SOCO,"7/8/2024 8 p.m. CDT",38651,38523,41238,2587
SOCO,"7/8/2024 9 p.m. CDT",37467,37277,39842,2375
SOCO,"7/8/2024 10 p.m. CDT",35107,34929,36811,1704
SOCO,"7/8/2024 11 p.m. CDT",32676,32484,33950,1274
SOCO,"7/9/2024 12 a.m. CDT",30407,30218,31607,1200
SOCO,"7/9/2024 1 a.m. CDT",29707,28426,30614,907
SOCO,"7/9/2024 2 a.m. CDT",28527,27122,29575,1048
SOCO,"7/9/2024 3 a.m. CDT",27597,26178,28707,1110
SOCO,"7/9/2024 4 a.m. CDT",27241,25862,28288,1047
SOCO,"7/9/2024 5 a.m. CDT",27527,26151,28567,1040
SOCO,"7/9/2024 6 a.m. CDT",27960,26763,29123,1163
SOCO,"7/9/2024 7 a.m. CDT",28679,27916,30343,1664
SOCO,"7/9/2024 8 a.m. CDT",29945,29442,31878,1933
SOCO,"7/9/2024 9 a.m. CDT",32019,31489,34450,2431
SOCO,"7/9/2024 10 a.m. CDT",34032,33718,36751,2719
SOCO,"7/9/2024 11 a.m. CDT",36549,36311,39320,2771
SOCO,"7/9/2024 12 p.m. CDT",38711,38460,41583,2872
SOCO,"7/9/2024 1 p.m. CDT",40313,40052,42991,2678
SOCO,"7/9/2024 2 p.m. CDT",41443,41090,44572,3129
SOCO,"7/9/2024 3 p.m. CDT",42053,41813,45118,3065
SOCO,"7/9/2024 4 p.m. CDT",41853,41476,45216,3363
SOCO,"7/9/2024 5 p.m. CDT",40599,40224,43943,3344
SOCO,"7/9/2024 6 p.m. CDT",39069,38703,42376,3307
SOCO,"7/9/2024 7 p.m. CDT",37772,37497,41222,3450
SOCO,"7/9/2024 8 p.m. CDT",36340,36086,39432,3092
SOCO,"7/9/2024 9 p.m. CDT",35641,35142,38150,2509
SOCO,"7/9/2024 10 p.m. CDT",33914,33439,36408,2494
SOCO,"7/9/2024 11 p.m. CDT",31746,31234,33767,2021
SOCO,"7/10/2024 12 a.m. CDT",29785,29292,31428,1643
SOCO,"7/10/2024 1 a.m. CDT",28459,27754,30047,1588
SOCO,"7/10/2024 2 a.m. CDT",27288,26558,28798,1510
SOCO,"7/10/2024 3 a.m. CDT",26629,25919,28122,1493
SOCO,"7/10/2024 4 a.m. CDT",26319,25589,27799,1480
SOCO,"7/10/2024 5 a.m. CDT",26815,25744,28293,1478
SOCO,"7/10/2024 6 a.m. CDT",27433,26375,28839,1406
SOCO,"7/10/2024 7 a.m. CDT",27683,27127,29606,1923
SOCO,"7/10/2024 8 a.m. CDT",29158,28614,31282,2124
SOCO,"7/10/2024 9 a.m. CDT",30815,30230,33457,2642
SOCO,"7/10/2024 10 a.m. CDT",32174,31988,35146,2972
SOCO,"7/10/2024 11 a.m. CDT",34002,33792,36790,2788
SOCO,"7/10/2024 12 p.m. CDT",35655,35415,38683,3028
SOCO,"7/10/2024 1 p.m. CDT",37212,36961,40265,3053
SOCO,"7/10/2024 2 p.m. CDT",38295,37985,41082,2787
SOCO,"7/10/2024 3 p.m. CDT",38998,38716,41799,2801
SOCO,"7/10/2024 4 p.m. CDT",39368,39011,42233,2865
SOCO,"7/10/2024 5 p.m. CDT",39428,39149,42416,2988
SOCO,"7/10/2024 6 p.m. CDT",38972,38783,42219,3247
SOCO,"7/10/2024 7 p.m. CDT",37893,37602,41152,3259
SOCO,"7/10/2024 8 p.m. CDT",36064,35864,39217,3153
SOCO,"7/10/2024 9 p.m. CDT",34705,34484,37592,2887
SOCO,"7/10/2024 10 p.m. CDT",32703,32195,35395,2692
SOCO,"7/10/2024 11 p.m. CDT",30006,29542,31656,1650
SOCO,"7/11/2024 12 a.m. CDT",28155,27324,29460,1305
SOCO,"7/11/2024 1 a.m. CDT",26361,25533,27496,1135
SOCO,"7/11/2024 2 a.m. CDT",25068,24239,25991,923
SOCO,"7/11/2024 3 a.m. CDT",24535,23383,25719,1184
SOCO,"7/11/2024 4 a.m. CDT",24166,22975,25430,1264
SOCO,"7/11/2024 5 a.m. CDT",24411,23228,25695,1284
SOCO,"7/11/2024 6 a.m. CDT",25106,23918,26296,1190
SOCO,"7/11/2024 7 a.m. CDT",25828,24917,27088,1260
SOCO,"7/11/2024 8 a.m. CDT",27100,26519,28796,1696
SOCO,"7/11/2024 9 a.m. CDT",29240,28626,31274,2034
SOCO,"7/11/2024 10 a.m. CDT",31274,30967,33352,2078
SOCO,"7/11/2024 11 a.m. CDT",33720,33421,35503,1783
SOCO,"7/11/2024 12 p.m. CDT",36060,35759,37932,1872
SOCO,"7/11/2024 1 p.m. CDT",37972,37632,40023,2051
SOCO,"7/11/2024 2 p.m. CDT",39593,39246,41885,2292
SOCO,"7/11/2024 3 p.m. CDT",40473,40215,43236,2763
SOCO,"7/11/2024 4 p.m. CDT",41264,41011,44068,2804
SOCO,"7/11/2024 5 p.m. CDT",41313,41170,44260,2947
SOCO,"7/11/2024 6 p.m. CDT",40731,40637,43648,2917
SOCO,"7/11/2024 7 p.m. CDT",39522,39652,41920,2398
SOCO,"7/11/2024 8 p.m. CDT",37571,37682,39666,2095
SOCO,"7/11/2024 9 p.m. CDT",35834,35893,37566,1732
SOCO,"7/11/2024 10 p.m. CDT",33723,33493,35049,1326
SOCO,"7/11/2024 11 p.m. CDT",31041,30528,31907,866
SOCO,"7/12/2024 12 a.m. CDT",28606,28103,29710,1104
SOCO,"7/12/2024 1 a.m. CDT",27189,26202,28287,1098
SOCO,"7/12/2024 2 a.m. CDT",25695,24632,26697,1002
SOCO,"7/12/2024 3 a.m. CDT",24705,23683,25858,1153
SOCO,"7/12/2024 4 a.m. CDT",24377,23363,25637,1260
SOCO,"7/12/2024 5 a.m. CDT",24618,23601,25978,1360
SOCO,"7/12/2024 6 a.m. CDT",25361,24201,26745,1384
SOCO,"7/12/2024 7 a.m. CDT",26065,25119,27540,1475
SOCO,"7/12/2024 8 a.m. CDT",27962,26991,29637,1675
SOCO,"7/12/2024 9 a.m. CDT",30387,29519,32058,1671
SOCO,"7/12/2024 10 a.m. CDT",32824,32519,34568,1744
SOCO,"7/12/2024 11 a.m. CDT",35831,35512,37566,1735
SOCO,"7/12/2024 12 p.m. CDT",38070,37963,40026,1956
SOCO,"7/12/2024 1 p.m. CDT",39630,39591,41496,1866
SOCO,"7/12/2024 2 p.m. CDT",40763,40716,42949,2186
SOCO,"7/12/2024 3 p.m. CDT",41447,41481,43320,1873
SOCO,"7/12/2024 4 p.m. CDT",41997,42001,43647,1650
SOCO,"7/12/2024 5 p.m. CDT",41897,41872,43641,1744
SOCO,"7/12/2024 6 p.m. CDT",41357,41324,43391,2034
SOCO,"7/12/2024 7 p.m. CDT",40089,40166,41975,1886
SOCO,"7/12/2024 8 p.m. CDT",38240,38344,39816,1576
SOCO,"7/12/2024 9 p.m. CDT",36715,36655,38122,1407
SOCO,"7/12/2024 10 p.m. CDT",34477,34340,35808,1331
SOCO,"7/12/2024 11 p.m. CDT",32042,31816,33236,1194
SOCO,"7/13/2024 12 a.m. CDT",29609,29277,30543,934
SOCO,"7/13/2024 1 a.m. CDT",27986,27265,29008,1022
SOCO,"7/13/2024 2 a.m. CDT",26705,25671,27804,1099
SOCO,"7/13/2024 3 a.m. CDT",25557,24505,26865,1308
SOCO,"7/13/2024 4 a.m. CDT",24935,23877,26102,1167
SOCO,"7/13/2024 5 a.m. CDT",24640,23598,25797,1157
SOCO,"7/13/2024 6 a.m. CDT",24547,23510,25872,1325
SOCO,"7/13/2024 7 a.m. CDT",24566,23884,26288,1722
SOCO,"7/13/2024 8 a.m. CDT",26489,25750,28448,1959
SOCO,"7/13/2024 9 a.m. CDT",29364,28718,31247,1883
SOCO,"7/13/2024 10 a.m. CDT",32502,32104,34535,2033
SOCO,"7/13/2024 11 a.m. CDT",35775,35615,37938,2163
SOCO,"7/13/2024 12 p.m. CDT",38395,38356,40609,2214
SOCO,"7/13/2024 1 p.m. CDT",39849,39817,42528,2679
SOCO,"7/13/2024 2 p.m. CDT",40637,40585,43587,2950
SOCO,"7/13/2024 3 p.m. CDT",41133,41079,44131,2998
SOCO,"7/13/2024 4 p.m. CDT",41701,41726,44572,2871
SOCO,"7/13/2024 5 p.m. CDT",41709,41772,44520,2811
SOCO,"7/13/2024 6 p.m. CDT",41088,41199,43975,2887
SOCO,"7/13/2024 7 p.m. CDT",39940,40115,42912,2972
SOCO,"7/13/2024 8 p.m. CDT",38372,38482,41245,2873
SOCO,"7/13/2024 9 p.m. CDT",37073,37080,39532,2459
SOCO,"7/13/2024 10 p.m. CDT",34834,34812,36803,1969
SOCO,"7/13/2024 11 p.m. CDT",32481,32159,33986,1505
SOCO,"7/14/2024 12 a.m. CDT",30231,29893,31786,1555
SOCO,"7/14/2024 1 a.m. CDT",28523,27936,29906,1383
SOCO,"7/14/2024 2 a.m. CDT",26875,26310,28226,1351
SOCO,"7/14/2024 3 a.m. CDT",26081,25154,27437,1356
SOCO,"7/14/2024 4 a.m. CDT",25341,24429,26535,1194
SOCO,"7/14/2024 5 a.m. CDT",24888,23967,25993,1105
SOCO,"7/14/2024 6 a.m. CDT",24473,23566,25673,1200
SOCO,"7/14/2024 7 a.m. CDT",24443,23892,26348,1905
SOCO,"7/14/2024 8 a.m. CDT",26454,25857,28766,2312
SOCO,"7/14/2024 9 a.m. CDT",29556,28955,31681,2125
SOCO,"7/14/2024 10 a.m. CDT",32777,32523,35103,2326
SOCO,"7/14/2024 11 a.m. CDT",36103,35954,38523,2420
SOCO,"7/14/2024 12 p.m. CDT",38879,38837,41942,3063
SOCO,"7/14/2024 1 p.m. CDT",40565,40549,43677,3112
SOCO,"7/14/2024 2 p.m. CDT",41579,41551,45010,3431
SOCO,"7/14/2024 3 p.m. CDT",42152,42109,45256,3104
SOCO,"7/14/2024 4 p.m. CDT",42574,42620,45393,2819
SOCO,"7/14/2024 5 p.m. CDT",42461,42514,45351,2890
SOCO,"7/14/2024 6 p.m. CDT",41833,41930,44627,2794
SOCO,"7/14/2024 7 p.m. CDT",40759,40538,43404,2645
SOCO,"7/14/2024 8 p.m. CDT",39119,38961,41888,2769
SOCO,"7/14/2024 9 p.m. CDT",37806,37600,40664,2858
SOCO,"7/14/2024 10 p.m. CDT",35652,35491,37819,2167
SOCO,"7/14/2024 11 p.m. CDT",33320,32980,34691,1371
SOCO,"7/15/2024 12 a.m. CDT",31183,30684,32487,1304
SOCO,"7/15/2024 1 a.m. CDT",29888,29036,31021,1133
SOCO,"7/15/2024 2 a.m. CDT",28528,27578,29764,1236
SOCO,"7/15/2024 3 a.m. CDT",27954,26711,28942,988
SOCO,"7/15/2024 4 a.m. CDT",27416,26165,28359,943
SOCO,"7/15/2024 5 a.m. CDT",27733,26484,28783,1050
SOCO,"7/15/2024 6 a.m. CDT",28403,27229,29344,941
SOCO,"7/15/2024 7 a.m. CDT",29116,28175,31063,1947
SOCO,"7/15/2024 8 a.m. CDT",30245,29724,32352,2107
SOCO,"7/15/2024 9 a.m. CDT",32431,31871,34595,2164
SOCO,"7/15/2024 10 a.m. CDT",34626,34377,36894,2268
SOCO,"7/15/2024 11 a.m. CDT",37505,37461,40781,3276
SOCO,"7/15/2024 12 p.m. CDT",40016,40060,43980,3964
SOCO,"7/15/2024 1 p.m. CDT",42351,42340,46295,3944
SOCO,"7/15/2024 2 p.m. CDT",43671,43652,47131,3460
SOCO,"7/15/2024 3 p.m. CDT",43616,43590,46987,3371
SOCO,"7/15/2024 4 p.m. CDT",42821,42853,46190,3369
SOCO,"7/15/2024 5 p.m. CDT",40863,40890,44339,3476
SOCO,"7/15/2024 6 p.m. CDT",39366,39396,42877,3511
SOCO,"7/15/2024 7 p.m. CDT",38125,38208,41496,3371
SOCO,"7/15/2024 8 p.m. CDT",36770,36902,40414,3644
SOCO,"7/15/2024 9 p.m. CDT",35607,35687,39421,3814
SOCO,"7/15/2024 10 p.m. CDT",33759,33568,36772,3013
SOCO,"7/15/2024 11 p.m. CDT",31600,31079,33610,2010
SOCO,"7/16/2024 12 a.m. CDT",29458,28948,30766,1308
SOCO,"7/16/2024 1 a.m. CDT",28358,27280,29271,913
SOCO,"7/16/2024 2 a.m. CDT",27475,26127,28486,1011
SOCO,"7/16/2024 3 a.m. CDT",26582,25251,27673,1091
SOCO,"7/16/2024 4 a.m. CDT",26264,24937,27237,973
SOCO,"7/16/2024 5 a.m. CDT",26500,25264,27453,953
SOCO,"7/16/2024 6 a.m. CDT",26826,25990,28147,1321
SOCO,"7/16/2024 7 a.m. CDT",27799,26960,29991,2192
SOCO,"7/16/2024 8 a.m. CDT",29180,28712,31860,2680
SOCO,"7/16/2024 9 a.m. CDT",31595,31049,33870,2275
SOCO,"7/16/2024 10 a.m. CDT",34265,33853,36714,2449
SOCO,"7/16/2024 11 a.m. CDT",37073,36766,40702,3629
SOCO,"7/16/2024 12 p.m. CDT",39247,39244,43664,4417
SOCO,"7/16/2024 1 p.m. CDT",40935,40962,45356,4421
SOCO,"7/16/2024 2 p.m. CDT",41391,41344,45948,4557
SOCO,"7/16/2024 3 p.m. CDT",41213,41188,45488,4275
SOCO,"7/16/2024 4 p.m. CDT",41167,41165,45282,4115
SOCO,"7/16/2024 5 p.m. CDT",40853,40999,45012,4159
SOCO,"7/16/2024 6 p.m. CDT",40094,40139,44004,3910
SOCO,"7/16/2024 7 p.m. CDT",39092,39137,43023,3931
SOCO,"7/16/2024 8 p.m. CDT",37538,37608,41456,3918
SOCO,"7/16/2024 9 p.m. CDT",36305,36399,40156,3851
SOCO,"7/16/2024 10 p.m. CDT",34266,34055,36907,2641
SOCO,"7/16/2024 11 p.m. CDT",31990,31623,33500,1510
SOCO,"7/17/2024 12 a.m. CDT",29977,29497,30907,930
SOCO,"7/17/2024 1 a.m. CDT",28729,27836,29606,877
SOCO,"7/17/2024 2 a.m. CDT",27859,26657,28745,886
SOCO,"7/17/2024 3 a.m. CDT",26948,25675,27967,1019
SOCO,"7/17/2024 4 a.m. CDT",26654,25398,27681,1027
SOCO,"7/17/2024 5 a.m. CDT",26967,25709,27910,943
SOCO,"7/17/2024 6 a.m. CDT",27423,26411,28346,923
SOCO,"7/17/2024 7 a.m. CDT",28233,27394,29582,1349
SOCO,"7/17/2024 8 a.m. CDT",29707,28866,31462,1755
SOCO,"7/17/2024 9 a.m. CDT",31482,30909,33213,1731
SOCO,"7/17/2024 10 a.m. CDT",34060,33649,35955,1895
SOCO,"7/17/2024 11 a.m. CDT",37003,36717,39795,2792
SOCO,"7/17/2024 12 p.m. CDT",39436,39158,42299,2863
SOCO,"7/17/2024 1 p.m. CDT",40925,40925,43920,2995
SOCO,"7/17/2024 2 p.m. CDT",41405,41470,44422,3017
SOCO,"7/17/2024 3 p.m. CDT",40595,40669,43726,3131
SOCO,"7/17/2024 4 p.m. CDT",39442,39541,42435,2993
SOCO,"7/17/2024 5 p.m. CDT",38131,38318,41410,3279
SOCO,"7/17/2024 6 p.m. CDT",37021,37155,40328,3307
SOCO,"7/17/2024 7 p.m. CDT",36062,36174,38979,2917
SOCO,"7/17/2024 8 p.m. CDT",34922,35053,37553,2631
SOCO,"7/17/2024 9 p.m. CDT",34012,34141,36825,2813
SOCO,"7/17/2024 10 p.m. CDT",32152,32285,34519,2367
SOCO,"7/17/2024 11 p.m. CDT",30116,29835,31734,1618
SOCO,"7/18/2024 12 a.m. CDT",28273,27947,29682,1409
SOCO,"7/18/2024 1 a.m. CDT",27053,26374,28503,1450
SOCO,"7/18/2024 2 a.m. CDT",25750,25101,27345,1595
SOCO,"7/18/2024 3 a.m. CDT",25330,24572,26949,1619
SOCO,"7/18/2024 4 a.m. CDT",25346,24342,27069,1723
SOCO,"7/18/2024 5 a.m. CDT",25835,24802,27509,1674
SOCO,"7/18/2024 6 a.m. CDT",26513,25473,28011,1498
SOCO,"7/18/2024 7 a.m. CDT",27001,26468,28776,1775
SOCO,"7/18/2024 8 a.m. CDT",28475,27917,30683,2208
SOCO,"7/18/2024 9 a.m. CDT",30424,29845,32680,2256
SOCO,"7/18/2024 10 a.m. CDT",32390,32142,34215,1825
SOCO,"7/18/2024 11 a.m. CDT",35004,34825,36976,1972
SOCO,"7/18/2024 12 p.m. CDT",37575,37342,39452,1877
SOCO,"7/18/2024 1 p.m. CDT",39639,39489,41808,2169
SOCO,"7/18/2024 2 p.m. CDT",40596,40427,42597,2001
SOCO,"7/18/2024 3 p.m. CDT",40015,39869,42279,2264
SOCO,"7/18/2024 4 p.m. CDT",38819,38730,41265,2446
SOCO,"7/18/2024 5 p.m. CDT",37774,37692,40246,2472
SOCO,"7/18/2024 6 p.m. CDT",36488,36466,39032,2544
SOCO,"7/18/2024 7 p.m. CDT",35337,35324,37608,2271
SOCO,"7/18/2024 8 p.m. CDT",34086,34079,36219,2133
SOCO,"7/18/2024 9 p.m. CDT",33197,33175,35580,2383
SOCO,"7/18/2024 10 p.m. CDT",31352,31308,33603,2251
SOCO,"7/18/2024 11 p.m. CDT",29340,29156,30771,1431
SOCO,"7/19/2024 12 a.m. CDT",27894,28887,29155,1261
SOCO,"7/19/2024 1 a.m. CDT",26293,27263,27601,1308
SOCO,"7/19/2024 2 a.m. CDT",25101,27263,26478,1377
SOCO,"7/19/2024 3 a.m. CDT",24749,27263,26130,1381
SOCO,"7/19/2024 4 a.m. CDT",24616,27263,25970,1354
SOCO,"7/19/2024 5 a.m. CDT",24656,27263,25915,1259
SOCO,"7/19/2024 6 a.m. CDT",25416,27263,26661,1245
SOCO,"7/19/2024 7 a.m. CDT",26252,27263,28036,1784
SOCO,"7/19/2024 8 a.m. CDT",27538,27372,29608,2070
SOCO,"7/19/2024 9 a.m. CDT",28947,28489,31186,2239
SOCO,"7/19/2024 10 a.m. CDT",30414,30169,32654,2240
SOCO,"7/19/2024 11 a.m. CDT",31950,31815,34174,2224
SOCO,"7/19/2024 12 p.m. CDT",33234,33099,35826,2592
SOCO,"7/19/2024 1 p.m. CDT",34397,34232,36785,2388
SOCO,"7/19/2024 2 p.m. CDT",35415,35102,37738,2323
SOCO,"7/19/2024 3 p.m. CDT",36192,35907,38783,2591
SOCO,"7/19/2024 4 p.m. CDT",36326,36089,39134,2808
SOCO,"7/19/2024 5 p.m. CDT",35561,35324,38511,2950
SOCO,"7/19/2024 6 p.m. CDT",34025,33802,36787,2762
SOCO,"7/19/2024 7 p.m. CDT",32628,32417,34942,2314
SOCO,"7/19/2024 8 p.m. CDT",31600,31403,34053,2453
SOCO,"7/19/2024 9 p.m. CDT",30687,30490,33178,2491
SOCO,"7/19/2024 10 p.m. CDT",29157,29102,31527,2370
SOCO,"7/19/2024 11 p.m. CDT",27502,27342,29175,1673
SOCO,"7/20/2024 12 a.m. CDT",25877,25683,27748,1871
SOCO,"7/20/2024 1 a.m. CDT",25023,24360,26517,1494
SOCO,"7/20/2024 2 a.m. CDT",24092,23415,25765,1673
SOCO,"7/20/2024 3 a.m. CDT",23541,22868,25090,1549
SOCO,"7/20/2024 4 a.m. CDT",23489,22451,25078,1589
SOCO,"7/20/2024 5 a.m. CDT",23509,22470,25135,1626
SOCO,"7/20/2024 6 a.m. CDT",23723,22702,25447,1724
SOCO,"7/20/2024 7 a.m. CDT",23671,23069,25799,2128
SOCO,"7/20/2024 8 a.m. CDT",24853,24269,27234,2381
SOCO,"7/20/2024 9 a.m. CDT",26422,25815,29012,2590
SOCO,"7/20/2024 10 a.m. CDT",28066,27580,30746,2680
SOCO,"7/20/2024 11 a.m. CDT",29345,29150,32125,2780
SOCO,"7/20/2024 12 p.m. CDT",30608,30431,33421,2813
SOCO,"7/20/2024 1 p.m. CDT",31747,31570,34648,2901
SOCO,"7/20/2024 2 p.m. CDT",32711,32409,35888,3177
SOCO,"7/20/2024 3 p.m. CDT",33089,32770,36282,3193
SOCO,"7/20/2024 4 p.m. CDT",33629,33312,36899,3270
SOCO,"7/20/2024 5 p.m. CDT",33772,33445,36731,2959
SOCO,"7/20/2024 6 p.m. CDT",33459,33137,36289,2830
SOCO,"7/20/2024 7 p.m. CDT",32643,32337,35726,3083
SOCO,"7/20/2024 8 p.m. CDT",31442,31165,34564,3122
SOCO,"7/20/2024 9 p.m. CDT",30799,30393,33625,2826
SOCO,"7/20/2024 10 p.m. CDT",29356,29099,32058,2702
SOCO,"7/20/2024 11 p.m. CDT",27745,27493,29925,2180
SOCO,"7/21/2024 12 a.m. CDT",26595,25971,28524,1929
SOCO,"7/21/2024 1 a.m. CDT",25281,24703,27233,1952
SOCO,"7/21/2024 2 a.m. CDT",24240,23633,26199,1959
SOCO,"7/21/2024 3 a.m. CDT",23693,23123,25618,1925
SOCO,"7/21/2024 4 a.m. CDT",23405,22855,25182,1777
SOCO,"7/21/2024 5 a.m. CDT",23305,22743,25155,1850
SOCO,"7/21/2024 6 a.m. CDT",23422,22861,25384,1962
SOCO,"7/21/2024 7 a.m. CDT",23637,23095,25935,2298
SOCO,"7/21/2024 8 a.m. CDT",24872,24282,27717,2845
SOCO,"7/21/2024 9 a.m. CDT",26410,26021,29317,2907
SOCO,"7/21/2024 10 a.m. CDT",28145,27882,30936,2791
SOCO,"7/21/2024 11 a.m. CDT",30192,29977,33077,2885
SOCO,"7/21/2024 12 p.m. CDT",31977,31815,34858,2881
SOCO,"7/21/2024 1 p.m. CDT",33417,33231,36142,2725
SOCO,"7/21/2024 2 p.m. CDT",34716,34421,37447,2731
SOCO,"7/21/2024 3 p.m. CDT",35225,34989,38179,2954
SOCO,"7/21/2024 4 p.m. CDT",35007,34766,37911,2904
SOCO,"7/21/2024 5 p.m. CDT",34377,34155,37356,2979
SOCO,"7/21/2024 6 p.m. CDT",33324,33139,36345,3021
SOCO,"7/21/2024 7 p.m. CDT",32286,32083,35546,3260
SOCO,"7/21/2024 8 p.m. CDT",31312,31078,34354,3042
SOCO,"7/21/2024 9 p.m. CDT",30574,30230,33610,3036
SOCO,"7/21/2024 10 p.m. CDT",29037,28695,31958,2921
SOCO,"7/21/2024 11 p.m. CDT",27276,26951,29433,2157
SOCO,"7/22/2024 12 a.m. CDT",25908,25210,28027,2119
SOCO,"7/22/2024 1 a.m. CDT",24612,23930,26672,2060
SOCO,"7/22/2024 2 a.m. CDT",23608,22921,25746,2138
SOCO,"7/22/2024 3 a.m. CDT",23096,22414,25202,2106
SOCO,"7/22/2024 4 a.m. CDT",23179,22486,25215,2036
SOCO,"7/22/2024 5 a.m. CDT",23776,23009,25744,1968
SOCO,"7/22/2024 6 a.m. CDT",25070,24138,27015,1945
SOCO,"7/22/2024 7 a.m. CDT",25746,25135,27900,2154
SOCO,"7/22/2024 8 a.m. CDT",26981,26406,29821,2840
SOCO,"7/22/2024 9 a.m. CDT",28417,28040,31453,3036
SOCO,"7/22/2024 10 a.m. CDT",30287,30117,33186,2899
SOCO,"7/22/2024 11 a.m. CDT",32329,32170,35129,2800
SOCO,"7/22/2024 12 p.m. CDT",34364,34203,36905,2541
SOCO,"7/22/2024 1 p.m. CDT",36218,35999,38915,2697
SOCO,"7/22/2024 2 p.m. CDT",37684,37455,40279,2595
SOCO,"7/22/2024 3 p.m. CDT",38847,38628,41424,2577
SOCO,"7/22/2024 4 p.m. CDT",39579,39413,41576,1997
SOCO,"7/22/2024 5 p.m. CDT",39531,39399,41547,2016
SOCO,"7/22/2024 6 p.m. CDT",38857,38761,40902,2045
SOCO,"7/22/2024 7 p.m. CDT",37688,37622,39889,2201
SOCO,"7/22/2024 8 p.m. CDT",36162,36086,38406,2244
SOCO,"7/22/2024 9 p.m. CDT",34881,34757,37298,2417
SOCO,"7/22/2024 10 p.m. CDT",32656,32548,34976,2320
SOCO,"7/22/2024 11 p.m. CDT",30338,30122,32146,1808
SOCO,"7/23/2024 12 a.m. CDT",28698,28009,30386,1688
SOCO,"7/23/2024 1 a.m. CDT",27356,26412,28721,1365
SOCO,"7/23/2024 2 a.m. CDT",26258,25306,27956,1698
SOCO,"7/23/2024 3 a.m. CDT",25523,24573,27276,1753
SOCO,"7/23/2024 4 a.m. CDT",25279,24332,26996,1717
SOCO,"7/23/2024 5 a.m. CDT",25623,24663,27165,1542
SOCO,"7/23/2024 6 a.m. CDT",26589,25645,28007,1418
SOCO,"7/23/2024 7 a.m. CDT",27348,26610,29455,2107
SOCO,"7/23/2024 8 a.m. CDT",28652,28050,31463,2811
SOCO,"7/23/2024 9 a.m. CDT",30264,29994,33183,2919
SOCO,"7/23/2024 10 a.m. CDT",32727,32403,35533,2806
SOCO,"7/23/2024 11 a.m. CDT",35353,35240,38227,2874
SOCO,"7/23/2024 12 p.m. CDT",37666,37543,40512,2846
SOCO,"7/23/2024 1 p.m. CDT",39363,39352,42076,2713
SOCO,"7/23/2024 2 p.m. CDT",40234,40129,42722,2488
SOCO,"7/23/2024 3 p.m. CDT",40521,40653,42920,2399
SOCO,"7/23/2024 4 p.m. CDT",40170,40312,42459,2289
SOCO,"7/23/2024 5 p.m. CDT",38817,38932,41152,2335
SOCO,"7/23/2024 6 p.m. CDT",37197,37305,39543,2346
SOCO,"7/23/2024 7 p.m. CDT",35684,35889,38209,2525
SOCO,"7/23/2024 8 p.m. CDT",34412,34764,36980,2568
SOCO,"7/23/2024 9 p.m. CDT",33323,33741,36034,2711
SOCO,"7/23/2024 10 p.m. CDT",31502,31858,34125,2623
SOCO,"7/23/2024 11 p.m. CDT",29404,29451,31072,1668
SOCO,"7/24/2024 12 a.m. CDT",27493,27561,29037,1544
SOCO,"7/24/2024 1 a.m. CDT",26603,25994,27726,1123
SOCO,"7/24/2024 2 a.m. CDT",25643,24985,26877,1234
SOCO,"7/24/2024 3 a.m. CDT",25453,24369,26697,1244
SOCO,"7/24/2024 4 a.m. CDT",25236,24072,26486,1250
SOCO,"7/24/2024 5 a.m. CDT",25654,24449,26898,1244
SOCO,"7/24/2024 6 a.m. CDT",26540,25352,27756,1216
SOCO,"7/24/2024 7 a.m. CDT",27155,26316,28772,1617
SOCO,"7/24/2024 8 a.m. CDT",28081,27490,30439,2358
SOCO,"7/24/2024 9 a.m. CDT",29592,29045,32088,2496
SOCO,"7/24/2024 10 a.m. CDT",31042,30970,33456,2414
SOCO,"7/24/2024 11 a.m. CDT",33091,33178,35824,2733
SOCO,"7/24/2024 12 p.m. CDT",35386,35433,38252,2866
SOCO,"7/24/2024 1 p.m. CDT",37269,37286,40418,3149
SOCO,"7/24/2024 2 p.m. CDT",38345,38349,41305,2960
SOCO,"7/24/2024 3 p.m. CDT",38695,38721,41630,2935
SOCO,"7/24/2024 4 p.m. CDT",38517,38504,40749,2232
SOCO,"7/24/2024 5 p.m. CDT",37669,37745,40021,2352
SOCO,"7/24/2024 6 p.m. CDT",36207,36251,38529,2322
SOCO,"7/24/2024 7 p.m. CDT",34639,34709,37458,2819
SOCO,"7/24/2024 8 p.m. CDT",33281,33285,36137,2856
SOCO,"7/24/2024 9 p.m. CDT",32241,32320,34778,2537
SOCO,"7/24/2024 10 p.m. CDT",30547,30529,32855,2308
SOCO,"7/24/2024 11 p.m. CDT",29401,28614,30893,1492
SOCO,"7/25/2024 12 a.m. CDT",28105,26884,29278,1173
SOCO,"7/25/2024 1 a.m. CDT",26878,25557,27872,994
SOCO,"7/25/2024 2 a.m. CDT",25900,24559,26905,1005
SOCO,"7/25/2024 3 a.m. CDT",25314,23999,26260,946
SOCO,"7/25/2024 4 a.m. CDT",25232,23912,26294,1062
SOCO,"7/25/2024 5 a.m. CDT",25735,24424,26774,1039
SOCO,"7/25/2024 6 a.m. CDT",26733,25532,27769,1036
SOCO,"7/25/2024 7 a.m. CDT",27052,26460,28769,1717
SOCO,"7/25/2024 8 a.m. CDT",28130,27526,29968,1838
SOCO,"7/25/2024 9 a.m. CDT",29034,28806,31119,2085
SOCO,"7/25/2024 10 a.m. CDT",30668,30561,32994,2326
SOCO,"7/25/2024 11 a.m. CDT",32656,32645,35109,2453
SOCO,"7/25/2024 12 p.m. CDT",34537,34580,37093,2556
SOCO,"7/25/2024 1 p.m. CDT",36453,36362,38838,2385
SOCO,"7/25/2024 2 p.m. CDT",37831,37738,39860,2029
SOCO,"7/25/2024 3 p.m. CDT",38461,38382,40764,2303
SOCO,"7/25/2024 4 p.m. CDT",38134,38106,40543,2409
SOCO,"7/25/2024 5 p.m. CDT",37430,37422,39945,2515
SOCO,"7/25/2024 6 p.m. CDT",36858,36806,39050,2192
SOCO,"7/25/2024 7 p.m. CDT",35818,35794,38440,2622
SOCO,"7/25/2024 8 p.m. CDT",34489,34425,36978,2489
SOCO,"7/25/2024 9 p.m. CDT",33632,33452,35633,2001
SOCO,"7/25/2024 10 p.m. CDT",31677,31526,33882,2205
SOCO,"7/25/2024 11 p.m. CDT",29624,29213,30701,1077
SOCO,"7/26/2024 12 a.m. CDT",27922,27149,28821,899
SOCO,"7/26/2024 1 a.m. CDT",26780,25641,27837,1057
SOCO,"7/26/2024 2 a.m. CDT",25775,24548,26956,1181
SOCO,"7/26/2024 3 a.m. CDT",25174,23927,26248,1074
SOCO,"7/26/2024 4 a.m. CDT",25043,23811,26022,979
SOCO,"7/26/2024 5 a.m. CDT",25438,24222,26647,1209
SOCO,"7/26/2024 6 a.m. CDT",25955,25094,27370,1415
SOCO,"7/26/2024 7 a.m. CDT",26695,26101,28334,1639
SOCO,"7/26/2024 8 a.m. CDT",27853,27244,29849,1996
SOCO,"7/26/2024 9 a.m. CDT",29141,28864,31598,2457
SOCO,"7/26/2024 10 a.m. CDT",31125,30798,33464,2339
SOCO,"7/26/2024 11 a.m. CDT",33447,33174,35940,2493
SOCO,"7/26/2024 12 p.m. CDT",35547,35303,37640,2093
SOCO,"7/26/2024 1 p.m. CDT",37550,37338,40017,2467
SOCO,"7/26/2024 2 p.m. CDT",38978,38825,41562,2584
SOCO,"7/26/2024 3 p.m. CDT",39719,39708,42249,2530
SOCO,"7/26/2024 4 p.m. CDT",40136,40160,42293,2157
SOCO,"7/26/2024 5 p.m. CDT",39897,39932,41973,2076
SOCO,"7/26/2024 6 p.m. CDT",38843,38889,40701,1858
SOCO,"7/26/2024 7 p.m. CDT",37321,37404,39196,1875
SOCO,"7/26/2024 8 p.m. CDT",35540,35561,37450,1910
SOCO,"7/26/2024 9 p.m. CDT",34105,33897,35824,1719
SOCO,"7/26/2024 10 p.m. CDT",32375,31809,34277,1902
SOCO,"7/26/2024 11 p.m. CDT",30251,29733,31327,1076
SOCO,"7/27/2024 12 a.m. CDT",28369,27760,29362,993
SOCO,"7/27/2024 1 a.m. CDT",26830,26085,27783,953
SOCO,"7/27/2024 2 a.m. CDT",25564,24723,26484,920
SOCO,"7/27/2024 3 a.m. CDT",24922,23812,25946,1024
SOCO,"7/27/2024 4 a.m. CDT",24387,23315,25546,1159
SOCO,"7/27/2024 5 a.m. CDT",24324,23228,25454,1130
SOCO,"7/27/2024 6 a.m. CDT",24499,23435,25676,1177
SOCO,"7/27/2024 7 a.m. CDT",24691,23727,26362,1671
SOCO,"7/27/2024 8 a.m. CDT",25466,24868,27567,2101
SOCO,"7/27/2024 9 a.m. CDT",27361,26733,29563,2202
SOCO,"7/27/2024 10 a.m. CDT",29113,28897,31412,2299
SOCO,"7/27/2024 11 a.m. CDT",30771,30766,33032,2261
SOCO,"7/27/2024 12 p.m. CDT",32424,32412,34751,2327
SOCO,"7/27/2024 1 p.m. CDT",33712,33680,36161,2449
SOCO,"7/27/2024 2 p.m. CDT",34874,34835,37552,2678
SOCO,"7/27/2024 3 p.m. CDT",35739,35686,38239,2500
SOCO,"7/27/2024 4 p.m. CDT",36489,36390,38996,2507
SOCO,"7/27/2024 5 p.m. CDT",36411,36299,38766,2355
SOCO,"7/27/2024 6 p.m. CDT",35589,35515,37887,2298
SOCO,"7/27/2024 7 p.m. CDT",34074,34033,36353,2279
SOCO,"7/27/2024 8 p.m. CDT",32997,32973,35127,2130
SOCO,"7/27/2024 9 p.m. CDT",32126,32113,34341,2215
SOCO,"7/27/2024 10 p.m. CDT",30539,30512,32575,2036
SOCO,"7/27/2024 11 p.m. CDT",28790,28805,29677,887
SOCO,"7/28/2024 12 a.m. CDT",27010,26779,28195,1185
SOCO,"7/28/2024 1 a.m. CDT",25841,25173,27042,1201
SOCO,"7/28/2024 2 a.m. CDT",25140,24121,26367,1227
SOCO,"7/28/2024 3 a.m. CDT",24273,23297,25570,1297
SOCO,"7/28/2024 4 a.m. CDT",24154,22814,25491,1337
SOCO,"7/28/2024 5 a.m. CDT",23912,22661,25244,1332
SOCO,"7/28/2024 6 a.m. CDT",23529,22597,24862,1333
SOCO,"7/28/2024 7 a.m. CDT",23767,22832,25470,1703
SOCO,"7/28/2024 8 a.m. CDT",25085,24222,27086,2001
SOCO,"7/28/2024 9 a.m. CDT",26472,26210,28384,1912
SOCO,"7/28/2024 10 a.m. CDT",28491,28459,30443,1952
SOCO,"7/28/2024 11 a.m. CDT",30424,30398,32429,2005
SOCO,"7/28/2024 12 p.m. CDT",32247,32214,34369,2122
SOCO,"7/28/2024 1 p.m. CDT",33669,33585,35790,2121
SOCO,"7/28/2024 2 p.m. CDT",34292,34209,36565,2273
SOCO,"7/28/2024 3 p.m. CDT",34573,34486,37152,2579
SOCO,"7/28/2024 4 p.m. CDT",34573,34492,37362,2789
SOCO,"7/28/2024 5 p.m. CDT",34340,34304,37191,2851
SOCO,"7/28/2024 6 p.m. CDT",33688,33643,36571,2883
SOCO,"7/28/2024 7 p.m. CDT",32712,32703,35491,2779
SOCO,"7/28/2024 8 p.m. CDT",31834,31802,34389,2555
SOCO,"7/28/2024 9 p.m. CDT",31043,31056,33599,2556
SOCO,"7/28/2024 10 p.m. CDT",29433,29474,31587,2154
SOCO,"7/28/2024 11 p.m. CDT",27627,27539,28738,1111
SOCO,"7/29/2024 12 a.m. CDT",25860,25648,26929,1069
SOCO,"7/29/2024 1 a.m. CDT",25184,24353,26290,1106
SOCO,"7/29/2024 2 a.m. CDT",24491,23541,25608,1117
SOCO,"7/29/2024 3 a.m. CDT",24093,23154,25312,1219
SOCO,"7/29/2024 4 a.m. CDT",24033,23125,25174,1141
SOCO,"7/29/2024 5 a.m. CDT",24697,23785,25817,1120
SOCO,"7/29/2024 6 a.m. CDT",25887,24948,27030,1143
SOCO,"7/29/2024 7 a.m. CDT",26564,26003,28167,1603
SOCO,"7/29/2024 8 a.m. CDT",27482,27240,29080,1598
SOCO,"7/29/2024 9 a.m. CDT",29106,28808,30912,1806
SOCO,"7/29/2024 10 a.m. CDT",31229,31225,33102,1873
SOCO,"7/29/2024 11 a.m. CDT",33773,33759,35882,2109
SOCO,"7/29/2024 12 p.m. CDT",36194,36127,38363,2169
SOCO,"7/29/2024 1 p.m. CDT",37752,37704,40063,2311
SOCO,"7/29/2024 2 p.m. CDT",38441,38426,40581,2140
SOCO,"7/29/2024 3 p.m. CDT",38896,38847,41276,2380
SOCO,"7/29/2024 4 p.m. CDT",39230,39216,41819,2589
SOCO,"7/29/2024 5 p.m. CDT",39041,39197,41586,2545
SOCO,"7/29/2024 6 p.m. CDT",38460,38610,41052,2592
SOCO,"7/29/2024 7 p.m. CDT",37176,37320,39510,2334
SOCO,"7/29/2024 8 p.m. CDT",35523,35599,37636,2113
SOCO,"7/29/2024 9 p.m. CDT",34095,33971,36290,2195
SOCO,"7/29/2024 10 p.m. CDT",31960,31675,34064,2104
SOCO,"7/29/2024 11 p.m. CDT",29710,29212,30958,1248
SOCO,"7/30/2024 12 a.m. CDT",28019,27258,29216,1197
SOCO,"7/30/2024 1 a.m. CDT",26561,25634,27799,1238
SOCO,"7/30/2024 2 a.m. CDT",25686,24559,27010,1324
SOCO,"7/30/2024 3 a.m. CDT",25199,23922,26681,1482
SOCO,"7/30/2024 4 a.m. CDT",25067,23758,26630,1563
SOCO,"7/30/2024 5 a.m. CDT",25169,24247,26884,1715
SOCO,"7/30/2024 6 a.m. CDT",25794,25220,27458,1664
SOCO,"7/30/2024 7 a.m. CDT",26745,26170,28430,1685
SOCO,"7/30/2024 8 a.m. CDT",27816,27571,29631,1815
SOCO,"7/30/2024 9 a.m. CDT",29811,29527,31613,1802
SOCO,"7/30/2024 10 a.m. CDT",32445,32274,34545,2100
SOCO,"7/30/2024 11 a.m. CDT",35397,35364,37233,1836
SOCO,"7/30/2024 12 p.m. CDT",38109,38048,40035,1926
SOCO,"7/30/2024 1 p.m. CDT",40234,40168,42584,2350
SOCO,"7/30/2024 2 p.m. CDT",41353,41367,43960,2607
SOCO,"7/30/2024 3 p.m. CDT",42104,42185,45401,3297
SOCO,"7/30/2024 4 p.m. CDT",43017,43113,46620,3603
SOCO,"7/30/2024 5 p.m. CDT",42999,43096,46371,3372
SOCO,"7/30/2024 6 p.m. CDT",42318,42397,45534,3216
SOCO,"7/30/2024 7 p.m. CDT",40891,41043,43595,2704
SOCO,"7/30/2024 8 p.m. CDT",38246,38403,40762,2516
SOCO,"7/30/2024 9 p.m. CDT",36258,36232,38368,2110
SOCO,"7/30/2024 10 p.m. CDT",33876,33705,35873,1997
SOCO,"7/30/2024 11 p.m. CDT",31448,30928,32888,1440
SOCO,"7/31/2024 12 a.m. CDT",29322,28811,30675,1353
SOCO,"7/31/2024 1 a.m. CDT",28219,27116,29144,925
SOCO,"7/31/2024 2 a.m. CDT",27268,25831,28305,1037
SOCO,"7/31/2024 3 a.m. CDT",26768,25135,28032,1264
SOCO,"7/31/2024 4 a.m. CDT",26520,24911,27765,1245
SOCO,"7/31/2024 5 a.m. CDT",26400,25124,27666,1266
SOCO,"7/31/2024 6 a.m. CDT",27252,26033,28333,1081
SOCO,"7/31/2024 7 a.m. CDT",27190,26921,28938,1748
SOCO,"7/31/2024 8 a.m. CDT",28470,28212,30588,2118
SOCO,"7/31/2024 9 a.m. CDT",30299,29979,32650,2351
SOCO,"7/31/2024 10 a.m. CDT",32690,32470,35166,2476
SOCO,"7/31/2024 11 a.m. CDT",35613,35508,37912,2299
SOCO,"7/31/2024 12 p.m. CDT",38682,38623,41787,3105
SOCO,"7/31/2024 1 p.m. CDT",40973,40864,44104,3131
SOCO,"7/31/2024 2 p.m. CDT",42381,42297,45944,3563
SOCO,"7/31/2024 3 p.m. CDT",42900,42864,46167,3267
SOCO,"7/31/2024 4 p.m. CDT",42978,42934,46232,3254
SOCO,"7/31/2024 5 p.m. CDT",42135,42174,45490,3355
SOCO,"7/31/2024 6 p.m. CDT",41424,41408,44722,3298
SOCO,"7/31/2024 7 p.m. CDT",40190,40214,43799,3609
SOCO,"7/31/2024 8 p.m. CDT",38636,38620,42146,3510
SOCO,"7/31/2024 9 p.m. CDT",37252,37259,40542,3290
SOCO,"7/31/2024 10 p.m. CDT",35179,34904,37518,2339
SOCO,"7/31/2024 11 p.m. CDT",32777,32248,33720,943
SOCO,"8/1/2024 12 a.m. CDT",30390,29850,31163,773
