"BA Code","Timestamp (Hour Ending)","Demand (MWh)","Demand Forecast (MWh)","Net Generation (MWh)","Total Interchange (MWh)"
SOCO,"9/1/2024 12 a.m. CDT",27250,25664,28798,1548
SOCO,"9/1/2024 1 a.m. CDT",25764,25172,27211,1447
SOCO,"9/1/2024 2 a.m. CDT",24829,24024,26208,1379
SOCO,"9/1/2024 3 a.m. CDT",24228,23079,25692,1464
SOCO,"9/1/2024 4 a.m. CDT",23810,22550,25199,1389
SOCO,"9/1/2024 5 a.m. CDT",23392,22197,24789,1397
SOCO,"9/1/2024 6 a.m. CDT",23331,22232,24834,1503
SOCO,"9/1/2024 7 a.m. CDT",23009,22435,24822,1813
SOCO,"9/1/2024 8 a.m. CDT",24403,23826,26381,1978
SOCO,"9/1/2024 9 a.m. CDT",26719,26104,28647,1928
SOCO,"9/1/2024 10 a.m. CDT",29341,28676,31163,1822
SOCO,"9/1/2024 11 a.m. CDT",31910,31271,33810,1900
SOCO,"9/1/2024 12 p.m. CDT",34703,34079,36383,1680
SOCO,"9/1/2024 1 p.m. CDT",36759,36435,38611,1852
SOCO,"9/1/2024 2 p.m. CDT",38104,37828,40190,2086
SOCO,"9/1/2024 3 p.m. CDT",38189,37887,39903,1714
SOCO,"9/1/2024 4 p.m. CDT",37924,37627,39191,1267
SOCO,"9/1/2024 5 p.m. CDT",37246,36943,38724,1478
SOCO,"9/1/2024 6 p.m. CDT",36002,35749,37628,1626
SOCO,"9/1/2024 7 p.m. CDT",34464,34231,36006,1542
SOCO,"9/1/2024 8 p.m. CDT",33320,33114,35013,1693
SOCO,"9/1/2024 9 p.m. CDT",31741,31553,33791,2050
SOCO,"9/1/2024 10 p.m. CDT",29933,29644,31816,1883
SOCO,"9/1/2024 11 p.m. CDT",28128,27691,29328,1200
SOCO,"9/2/2024 12 a.m. CDT",26412,25954,27679,1267
SOCO,"9/2/2024 1 a.m. CDT",25258,24396,26487,1229
SOCO,"9/2/2024 2 a.m. CDT",24535,23289,25871,1336
SOCO,"9/2/2024 3 a.m. CDT",23804,22567,25128,1324
SOCO,"9/2/2024 4 a.m. CDT",23423,22210,24841,1418
SOCO,"9/2/2024 5 a.m. CDT",23324,22112,24765,1441
SOCO,"9/2/2024 6 a.m. CDT",23493,22336,24866,1373
SOCO,"9/2/2024 7 a.m. CDT",23130,22336,24733,1603
SOCO,"9/2/2024 8 a.m. CDT",24252,23407,25907,1655
SOCO,"9/2/2024 9 a.m. CDT",25942,25722,28329,2387
SOCO,"9/2/2024 10 a.m. CDT",28848,28589,30913,2065
SOCO,"9/2/2024 11 a.m. CDT",31856,31525,33855,1999
SOCO,"9/2/2024 12 p.m. CDT",34574,34252,36587,2013
SOCO,"9/2/2024 1 p.m. CDT",36908,36571,38542,1634
SOCO,"9/2/2024 2 p.m. CDT",38559,38186,39923,1364
SOCO,"9/2/2024 3 p.m. CDT",39737,39349,41658,1921
SOCO,"9/2/2024 4 p.m. CDT",40498,40151,42137,1639
SOCO,"9/2/2024 5 p.m. CDT",40601,40321,42185,1584
SOCO,"9/2/2024 6 p.m. CDT",39897,39637,41429,1532
SOCO,"9/2/2024 7 p.m. CDT",38293,38108,39678,1385
SOCO,"9/2/2024 8 p.m. CDT",36894,36608,38174,1280
SOCO,"9/2/2024 9 p.m. CDT",34915,34622,36186,1271
SOCO,"9/2/2024 10 p.m. CDT",32386,32015,33776,1390
SOCO,"9/2/2024 11 p.m. CDT",30096,29555,31147,1051
SOCO,"9/3/2024 12 a.m. CDT",27982,27476,29069,1087
SOCO,"9/3/2024 1 a.m. CDT",27123,25865,28208,1085
SOCO,"9/3/2024 2 a.m. CDT",26303,24753,27377,1074
SOCO,"9/3/2024 3 a.m. CDT",25720,24019,26787,1067
SOCO,"9/3/2024 4 a.m. CDT",25501,23829,26600,1099
SOCO,"9/3/2024 5 a.m. CDT",25547,24343,26577,1030
SOCO,"9/3/2024 6 a.m. CDT",27084,25874,28009,925
SOCO,"9/3/2024 7 a.m. CDT",27605,26984,28964,1359
SOCO,"9/3/2024 8 a.m. CDT",28192,27694,29833,1641
SOCO,"9/3/2024 9 a.m. CDT",29333,28836,31114,1781
SOCO,"9/3/2024 10 a.m. CDT",30736,30191,32382,1646
SOCO,"9/3/2024 11 a.m. CDT",31923,31625,34068,2145
SOCO,"9/3/2024 12 p.m. CDT",33373,33069,35403,2030
SOCO,"9/3/2024 1 p.m. CDT",34957,34615,37002,2045
SOCO,"9/3/2024 2 p.m. CDT",36330,35975,38234,1904
SOCO,"9/3/2024 3 p.m. CDT",37363,37012,39119,1756
SOCO,"9/3/2024 4 p.m. CDT",38079,37800,39836,1757
SOCO,"9/3/2024 5 p.m. CDT",37992,37681,39605,1613
SOCO,"9/3/2024 6 p.m. CDT",36952,36685,38549,1597
SOCO,"9/3/2024 7 p.m. CDT",35609,35401,37298,1689
SOCO,"9/3/2024 8 p.m. CDT",34535,34282,36212,1677
SOCO,"9/3/2024 9 p.m. CDT",32848,32580,34618,1770
SOCO,"9/3/2024 10 p.m. CDT",30374,30087,32360,1986
SOCO,"9/3/2024 11 p.m. CDT",28314,27788,29597,1283
SOCO,"9/4/2024 12 a.m. CDT",26450,25924,27533,1083
SOCO,"9/4/2024 1 a.m. CDT",25670,24484,26625,955
SOCO,"9/4/2024 2 a.m. CDT",24854,23556,25967,1113
SOCO,"9/4/2024 3 a.m. CDT",24456,22756,25660,1204
SOCO,"9/4/2024 4 a.m. CDT",24191,22513,25491,1300
SOCO,"9/4/2024 5 a.m. CDT",24565,22954,25884,1319
SOCO,"9/4/2024 6 a.m. CDT",25485,24145,26746,1261
SOCO,"9/4/2024 7 a.m. CDT",25408,24882,27278,1870
SOCO,"9/4/2024 8 a.m. CDT",25641,25404,27779,2138
SOCO,"9/4/2024 9 a.m. CDT",26651,26389,29022,2371
SOCO,"9/4/2024 10 a.m. CDT",27757,27503,30093,2336
SOCO,"9/4/2024 11 a.m. CDT",29113,28809,31048,1935
SOCO,"9/4/2024 12 p.m. CDT",30570,30248,32469,1899
SOCO,"9/4/2024 1 p.m. CDT",32215,31907,34198,1983
SOCO,"9/4/2024 2 p.m. CDT",33127,33227,35077,1950
SOCO,"9/4/2024 3 p.m. CDT",35122,34440,37284,2162
SOCO,"9/4/2024 4 p.m. CDT",35441,35329,37980,2539
SOCO,"9/4/2024 5 p.m. CDT",35436,35493,37869,2433
SOCO,"9/4/2024 6 p.m. CDT",34958,34574,37383,2425
SOCO,"9/4/2024 7 p.m. CDT",33490,33379,35742,2252
SOCO,"9/4/2024 8 p.m. CDT",32893,32649,34959,2066
SOCO,"9/4/2024 9 p.m. CDT",31503,31250,33502,1999
SOCO,"9/4/2024 10 p.m. CDT",29060,29142,30892,1832
SOCO,"9/4/2024 11 p.m. CDT",28038,27197,29181,1143
SOCO,"9/5/2024 12 a.m. CDT",26351,25485,27578,1227
SOCO,"9/5/2024 1 a.m. CDT",25366,24188,26501,1135
SOCO,"9/5/2024 2 a.m. CDT",24542,23334,26029,1487
SOCO,"9/5/2024 3 a.m. CDT",24399,22831,25775,1376
SOCO,"9/5/2024 4 a.m. CDT",24329,22778,25766,1437
SOCO,"9/5/2024 5 a.m. CDT",24630,23309,25860,1230
SOCO,"9/5/2024 6 a.m. CDT",25518,24632,26497,979
SOCO,"9/5/2024 7 a.m. CDT",25853,25637,27495,1642
SOCO,"9/5/2024 8 a.m. CDT",26416,26170,28225,1809
SOCO,"9/5/2024 9 a.m. CDT",27302,27033,29073,1771
SOCO,"9/5/2024 10 a.m. CDT",28487,28231,30263,1776
SOCO,"9/5/2024 11 a.m. CDT",29863,29579,31994,2131
SOCO,"9/5/2024 12 p.m. CDT",31358,31070,33656,2298
SOCO,"9/5/2024 1 p.m. CDT",32863,32572,35474,2611
SOCO,"9/5/2024 2 p.m. CDT",33801,33537,36531,2730
SOCO,"9/5/2024 3 p.m. CDT",34501,34207,37416,2915
SOCO,"9/5/2024 4 p.m. CDT",34863,34689,37927,3064
SOCO,"9/5/2024 5 p.m. CDT",34851,34663,37990,3139
SOCO,"9/5/2024 6 p.m. CDT",34189,34000,37472,3283
SOCO,"9/5/2024 7 p.m. CDT",33277,33086,36537,3260
SOCO,"9/5/2024 8 p.m. CDT",32919,32655,35705,2786
SOCO,"9/5/2024 9 p.m. CDT",31477,31223,34364,2887
SOCO,"9/5/2024 10 p.m. CDT",29626,29355,32277,2651
SOCO,"9/5/2024 11 p.m. CDT",27488,27252,29399,1911
SOCO,"9/6/2024 12 a.m. CDT",26184,25581,27173,989
SOCO,"9/6/2024 1 a.m. CDT",25325,24232,26282,957
SOCO,"9/6/2024 2 a.m. CDT",24510,23371,25630,1120
SOCO,"9/6/2024 3 a.m. CDT",24204,22698,25285,1081
SOCO,"9/6/2024 4 a.m. CDT",24064,22552,25094,1030
SOCO,"9/6/2024 5 a.m. CDT",24544,23031,25519,975
SOCO,"9/6/2024 6 a.m. CDT",25621,24339,26398,777
SOCO,"9/6/2024 7 a.m. CDT",25756,25300,27290,1534
SOCO,"9/6/2024 8 a.m. CDT",26160,25743,27714,1554
SOCO,"9/6/2024 9 a.m. CDT",26704,26441,28242,1538
SOCO,"9/6/2024 10 a.m. CDT",27615,27325,29344,1729
SOCO,"9/6/2024 11 a.m. CDT",28536,28223,30342,1806
SOCO,"9/6/2024 12 p.m. CDT",29262,28967,31287,2025
SOCO,"9/6/2024 1 p.m. CDT",29961,29631,31988,2027
SOCO,"9/6/2024 2 p.m. CDT",30221,29935,32617,2396
SOCO,"9/6/2024 3 p.m. CDT",30114,29837,32823,2709
SOCO,"9/6/2024 4 p.m. CDT",29844,29634,32911,3067
SOCO,"9/6/2024 5 p.m. CDT",29295,29100,32667,3372
SOCO,"9/6/2024 6 p.m. CDT",28571,28390,31471,2900
SOCO,"9/6/2024 7 p.m. CDT",28057,27841,30690,2633
SOCO,"9/6/2024 8 p.m. CDT",28033,27756,30575,2542
SOCO,"9/6/2024 9 p.m. CDT",27259,26989,29669,2410
SOCO,"9/6/2024 10 p.m. CDT",26102,25848,28387,2285
SOCO,"9/6/2024 11 p.m. CDT",24802,24565,26498,1696
SOCO,"9/7/2024 12 a.m. CDT",23617,23314,25271,1654
SOCO,"9/7/2024 1 a.m. CDT",23152,22188,24396,1244
SOCO,"9/7/2024 2 a.m. CDT",22349,21375,23571,1222
SOCO,"9/7/2024 3 a.m. CDT",21813,20844,23014,1201
SOCO,"9/7/2024 4 a.m. CDT",21465,20518,22814,1349
SOCO,"9/7/2024 5 a.m. CDT",21575,20634,22910,1335
SOCO,"9/7/2024 6 a.m. CDT",21928,20989,23202,1274
SOCO,"9/7/2024 7 a.m. CDT",22287,21369,24023,1736
SOCO,"9/7/2024 8 a.m. CDT",22810,22216,24542,1732
SOCO,"9/7/2024 9 a.m. CDT",24144,23620,25956,1812
SOCO,"9/7/2024 10 a.m. CDT",25581,25308,27219,1638
SOCO,"9/7/2024 11 a.m. CDT",27267,27006,28978,1711
SOCO,"9/7/2024 12 p.m. CDT",28889,28591,30636,1747
SOCO,"9/7/2024 1 p.m. CDT",30601,30164,32159,1558
SOCO,"9/7/2024 2 p.m. CDT",31870,31431,33437,1567
SOCO,"9/7/2024 3 p.m. CDT",32790,32320,34567,1777
SOCO,"9/7/2024 4 p.m. CDT",33281,32852,34804,1523
SOCO,"9/7/2024 5 p.m. CDT",33186,32802,34755,1569
SOCO,"9/7/2024 6 p.m. CDT",32385,32008,34035,1650
SOCO,"9/7/2024 7 p.m. CDT",30865,30449,32148,1283
SOCO,"9/7/2024 8 p.m. CDT",29806,29405,30756,950
SOCO,"9/7/2024 9 p.m. CDT",28341,27959,29628,1287
SOCO,"9/7/2024 10 p.m. CDT",26541,26139,27463,922
SOCO,"9/7/2024 11 p.m. CDT",24837,24475,24934,97
SOCO,"9/8/2024 12 a.m. CDT",23129,22768,23377,248
SOCO,"9/8/2024 1 a.m. CDT",21974,21356,22323,349
SOCO,"9/8/2024 2 a.m. CDT",21490,20394,21917,427
SOCO,"9/8/2024 3 a.m. CDT",21070,19637,21439,369
SOCO,"9/8/2024 4 a.m. CDT",20667,19251,21063,396
SOCO,"9/8/2024 5 a.m. CDT",20471,19076,21088,617
SOCO,"9/8/2024 6 a.m. CDT",20312,19283,20769,457
SOCO,"9/8/2024 7 a.m. CDT",20534,19540,21426,892
SOCO,"9/8/2024 8 a.m. CDT",20910,20413,21785,875
SOCO,"9/8/2024 9 a.m. CDT",21883,21674,22930,1047
SOCO,"9/8/2024 10 a.m. CDT",23131,22910,23987,856
SOCO,"9/8/2024 11 a.m. CDT",24353,24107,25132,779
SOCO,"9/8/2024 12 p.m. CDT",25824,25549,26505,681
SOCO,"9/8/2024 1 p.m. CDT",27600,27275,28195,595
SOCO,"9/8/2024 2 p.m. CDT",29223,28849,29809,586
SOCO,"9/8/2024 3 p.m. CDT",30599,30226,31427,828
SOCO,"9/8/2024 4 p.m. CDT",31607,31222,32531,924
SOCO,"9/8/2024 5 p.m. CDT",31973,31567,32841,868
SOCO,"9/8/2024 6 p.m. CDT",31669,31320,32526,857
SOCO,"9/8/2024 7 p.m. CDT",30556,30234,31412,856
SOCO,"9/8/2024 8 p.m. CDT",29882,29557,30557,675
SOCO,"9/8/2024 9 p.m. CDT",28412,28129,29348,936
SOCO,"9/8/2024 10 p.m. CDT",26398,26117,27233,835
SOCO,"9/8/2024 11 p.m. CDT",24391,24056,24762,371
SOCO,"9/9/2024 12 a.m. CDT",23406,22421,23616,210
SOCO,"9/9/2024 1 a.m. CDT",22170,21109,22443,273
SOCO,"9/9/2024 2 a.m. CDT",21454,20387,21876,422
SOCO,"9/9/2024 3 a.m. CDT",21022,19953,21528,506
SOCO,"9/9/2024 4 a.m. CDT",21078,20036,21568,490
SOCO,"9/9/2024 5 a.m. CDT",21857,20792,22262,405
SOCO,"9/9/2024 6 a.m. CDT",23283,22251,23406,123
SOCO,"9/9/2024 7 a.m. CDT",24056,23492,24251,195
SOCO,"9/9/2024 8 a.m. CDT",24278,24091,24663,385
SOCO,"9/9/2024 9 a.m. CDT",25314,25085,25775,461
SOCO,"9/9/2024 10 a.m. CDT",26580,26311,27474,894
SOCO,"9/9/2024 11 a.m. CDT",27939,27736,28793,854
SOCO,"9/9/2024 12 p.m. CDT",29608,29297,30477,869
SOCO,"9/9/2024 1 p.m. CDT",31307,31001,32028,721
SOCO,"9/9/2024 2 p.m. CDT",32472,32335,33157,685
SOCO,"9/9/2024 3 p.m. CDT",33446,33322,34674,1228
SOCO,"9/9/2024 4 p.m. CDT",34147,34115,35585,1438
SOCO,"9/9/2024 5 p.m. CDT",34386,34380,35678,1292
SOCO,"9/9/2024 6 p.m. CDT",33731,33712,34675,944
SOCO,"9/9/2024 7 p.m. CDT",32608,32656,33852,1244
SOCO,"9/9/2024 8 p.m. CDT",31748,31683,32901,1153
SOCO,"9/9/2024 9 p.m. CDT",29962,29898,31128,1166
SOCO,"9/9/2024 10 p.m. CDT",27670,27600,29050,1380
SOCO,"9/9/2024 11 p.m. CDT",25876,25356,26529,653
SOCO,"9/10/2024 12 a.m. CDT",24358,23499,24893,535
SOCO,"9/10/2024 1 a.m. CDT",23376,22027,23595,219
SOCO,"9/10/2024 2 a.m. CDT",23027,21292,23355,328
SOCO,"9/10/2024 3 a.m. CDT",22537,20808,23076,539
SOCO,"9/10/2024 4 a.m. CDT",22355,20669,22839,484
SOCO,"9/10/2024 5 a.m. CDT",23030,21328,23353,323
SOCO,"9/10/2024 6 a.m. CDT",23838,22767,24138,300
SOCO,"9/10/2024 7 a.m. CDT",24426,23773,25082,656
SOCO,"9/10/2024 8 a.m. CDT",24795,24196,25789,994
SOCO,"9/10/2024 9 a.m. CDT",25447,25177,26931,1484
SOCO,"9/10/2024 10 a.m. CDT",26805,26541,28333,1528
SOCO,"9/10/2024 11 a.m. CDT",28313,28043,29774,1461
SOCO,"9/10/2024 12 p.m. CDT",29939,29687,31356,1417
SOCO,"9/10/2024 1 p.m. CDT",31471,31229,32940,1469
SOCO,"9/10/2024 2 p.m. CDT",32733,32406,34586,1853
SOCO,"9/10/2024 3 p.m. CDT",33653,33373,35993,2340
SOCO,"9/10/2024 4 p.m. CDT",34143,33804,36442,2299
SOCO,"9/10/2024 5 p.m. CDT",33835,33571,35938,2103
SOCO,"9/10/2024 6 p.m. CDT",32862,32583,34976,2114
SOCO,"9/10/2024 7 p.m. CDT",31891,31642,33924,2033
SOCO,"9/10/2024 8 p.m. CDT",31456,31158,33377,1921
SOCO,"9/10/2024 9 p.m. CDT",29573,29294,31366,1793
SOCO,"9/10/2024 10 p.m. CDT",27540,27335,28888,1348
SOCO,"9/10/2024 11 p.m. CDT",26075,25560,26846,771
SOCO,"9/11/2024 12 a.m. CDT",24615,23747,25105,490
SOCO,"9/11/2024 1 a.m. CDT",23772,22443,24146,374
SOCO,"9/11/2024 2 a.m. CDT",23296,21579,23608,312
SOCO,"9/11/2024 3 a.m. CDT",22741,21009,23261,520
SOCO,"9/11/2024 4 a.m. CDT",22635,20974,23231,596
SOCO,"9/11/2024 5 a.m. CDT",23076,21565,23730,654
SOCO,"9/11/2024 6 a.m. CDT",24280,23102,24876,596
SOCO,"9/11/2024 7 a.m. CDT",24652,24078,25544,892
SOCO,"9/11/2024 8 a.m. CDT",24953,24429,25609,656
SOCO,"9/11/2024 9 a.m. CDT",25360,25103,26656,1296
SOCO,"9/11/2024 10 a.m. CDT",26297,26057,27665,1368
SOCO,"9/11/2024 11 a.m. CDT",27380,27107,28949,1569
SOCO,"9/11/2024 12 p.m. CDT",28336,28059,30135,1799
SOCO,"9/11/2024 1 p.m. CDT",29162,28911,31127,1965
SOCO,"9/11/2024 2 p.m. CDT",29572,29369,31985,2413
SOCO,"9/11/2024 3 p.m. CDT",29763,29523,32512,2749
SOCO,"9/11/2024 4 p.m. CDT",29679,29510,32594,2915
SOCO,"9/11/2024 5 p.m. CDT",29388,29242,32416,3028
SOCO,"9/11/2024 6 p.m. CDT",28861,28680,31820,2959
SOCO,"9/11/2024 7 p.m. CDT",28581,28447,31257,2676
SOCO,"9/11/2024 8 p.m. CDT",28614,28469,31143,2529
SOCO,"9/11/2024 9 p.m. CDT",27675,27479,29661,1986
SOCO,"9/11/2024 10 p.m. CDT",26228,26030,27877,1649
SOCO,"9/11/2024 11 p.m. CDT",24886,24390,25916,1030
SOCO,"9/12/2024 12 a.m. CDT",23984,23131,24865,881
SOCO,"9/12/2024 1 a.m. CDT",23457,22143,24076,619
SOCO,"9/12/2024 2 a.m. CDT",22791,21497,23590,799
SOCO,"9/12/2024 3 a.m. CDT",22400,21099,23301,901
SOCO,"9/12/2024 4 a.m. CDT",22482,21175,23385,903
SOCO,"9/12/2024 5 a.m. CDT",23263,21983,24109,846
SOCO,"9/12/2024 6 a.m. CDT",24741,23498,25261,520
SOCO,"9/12/2024 7 a.m. CDT",25530,24638,26338,808
SOCO,"9/12/2024 8 a.m. CDT",25513,25001,26451,938
SOCO,"9/12/2024 9 a.m. CDT",26014,25528,27075,1061
SOCO,"9/12/2024 10 a.m. CDT",26467,25994,27717,1250
SOCO,"9/12/2024 11 a.m. CDT",26752,26524,28511,1759
SOCO,"9/12/2024 12 p.m. CDT",27128,26859,29112,1984
SOCO,"9/12/2024 1 p.m. CDT",27332,27091,29598,2266
SOCO,"9/12/2024 2 p.m. CDT",27480,27213,29816,2336
SOCO,"9/12/2024 3 p.m. CDT",27675,27387,30141,2466
SOCO,"9/12/2024 4 p.m. CDT",28020,27800,30419,2399
SOCO,"9/12/2024 5 p.m. CDT",28202,27952,30645,2443
SOCO,"9/12/2024 6 p.m. CDT",28043,27792,30349,2306
SOCO,"9/12/2024 7 p.m. CDT",28136,27901,30318,2182
SOCO,"9/12/2024 8 p.m. CDT",28357,28049,30664,2307
SOCO,"9/12/2024 9 p.m. CDT",27545,27263,29803,2258
SOCO,"9/12/2024 10 p.m. CDT",26529,25991,28406,1877
SOCO,"9/12/2024 11 p.m. CDT",24968,24460,26252,1284
SOCO,"9/13/2024 12 a.m. CDT",23976,23101,24816,840
SOCO,"9/13/2024 1 a.m. CDT",23531,22147,24132,601
SOCO,"9/13/2024 2 a.m. CDT",22850,21441,23521,671
SOCO,"9/13/2024 3 a.m. CDT",22578,21148,23345,767
SOCO,"9/13/2024 4 a.m. CDT",22644,21256,23507,863
SOCO,"9/13/2024 5 a.m. CDT",23163,21951,23948,785
SOCO,"9/13/2024 6 a.m. CDT",24623,23409,25053,430
SOCO,"9/13/2024 7 a.m. CDT",25168,24559,25817,649
SOCO,"9/13/2024 8 a.m. CDT",25321,25071,26161,840
SOCO,"9/13/2024 9 a.m. CDT",26142,25891,27023,881
SOCO,"9/13/2024 10 a.m. CDT",26969,26692,27930,961
SOCO,"9/13/2024 11 a.m. CDT",27774,27461,28790,1016
SOCO,"9/13/2024 12 p.m. CDT",28559,28199,29702,1143
SOCO,"9/13/2024 1 p.m. CDT",29266,28889,30799,1533
SOCO,"9/13/2024 2 p.m. CDT",29767,29430,31401,1634
SOCO,"9/13/2024 3 p.m. CDT",30112,29737,31681,1569
SOCO,"9/13/2024 4 p.m. CDT",30228,29848,31642,1414
SOCO,"9/13/2024 5 p.m. CDT",30105,29712,31542,1437
SOCO,"9/13/2024 6 p.m. CDT",29541,29154,30950,1409
SOCO,"9/13/2024 7 p.m. CDT",28894,28557,30408,1514
SOCO,"9/13/2024 8 p.m. CDT",28669,28304,30081,1412
SOCO,"9/13/2024 9 p.m. CDT",27865,27504,29404,1539
SOCO,"9/13/2024 10 p.m. CDT",26848,26379,28029,1181
SOCO,"9/13/2024 11 p.m. CDT",25583,25101,26387,804
SOCO,"9/14/2024 12 a.m. CDT",24216,23844,25148,932
SOCO,"9/14/2024 1 a.m. CDT",23378,22727,24268,890
SOCO,"9/14/2024 2 a.m. CDT",22875,21787,23679,804
SOCO,"9/14/2024 3 a.m. CDT",22646,21301,23431,785
SOCO,"9/14/2024 4 a.m. CDT",22375,20926,23180,805
SOCO,"9/14/2024 5 a.m. CDT",22356,20934,23129,773
SOCO,"9/14/2024 6 a.m. CDT",22657,21383,22989,332
SOCO,"9/14/2024 7 a.m. CDT",22585,21746,23489,904
SOCO,"9/14/2024 8 a.m. CDT",22994,22554,23948,954
SOCO,"9/14/2024 9 a.m. CDT",24013,23688,25452,1439
SOCO,"9/14/2024 10 a.m. CDT",25189,24841,26630,1441
SOCO,"9/14/2024 11 a.m. CDT",26271,25902,27806,1535
SOCO,"9/14/2024 12 p.m. CDT",26961,26588,28720,1759
SOCO,"9/14/2024 1 p.m. CDT",27509,27108,29311,1802
SOCO,"9/14/2024 2 p.m. CDT",27796,27392,29693,1897
SOCO,"9/14/2024 3 p.m. CDT",28010,27458,30197,2187
SOCO,"9/14/2024 4 p.m. CDT",28221,27695,30590,2369
SOCO,"9/14/2024 5 p.m. CDT",28210,27793,30839,2629
SOCO,"9/14/2024 6 p.m. CDT",28005,27642,30448,2443
SOCO,"9/14/2024 7 p.m. CDT",27777,27370,29890,2113
SOCO,"9/14/2024 8 p.m. CDT",27540,27055,29501,1961
SOCO,"9/14/2024 9 p.m. CDT",26838,26338,28788,1950
SOCO,"9/14/2024 10 p.m. CDT",25731,25286,27484,1753
SOCO,"9/14/2024 11 p.m. CDT",24538,24096,25981,1443
SOCO,"9/15/2024 12 a.m. CDT",23516,22975,24891,1375
SOCO,"9/15/2024 1 a.m. CDT",22605,21850,23528,923
SOCO,"9/15/2024 2 a.m. CDT",22048,21163,23013,965
SOCO,"9/15/2024 3 a.m. CDT",22024,20586,22957,933
SOCO,"9/15/2024 4 a.m. CDT",21750,20300,22713,963
SOCO,"9/15/2024 5 a.m. CDT",21374,20297,22468,1094
SOCO,"9/15/2024 6 a.m. CDT",21474,20537,22263,789
SOCO,"9/15/2024 7 a.m. CDT",21560,20990,22672,1112
SOCO,"9/15/2024 8 a.m. CDT",22339,21741,23488,1149
SOCO,"9/15/2024 9 a.m. CDT",23686,23063,25174,1488
SOCO,"9/15/2024 10 a.m. CDT",24854,24209,26344,1490
SOCO,"9/15/2024 11 a.m. CDT",25570,25169,27012,1442
SOCO,"9/15/2024 12 p.m. CDT",26389,26110,28247,1858
SOCO,"9/15/2024 1 p.m. CDT",27216,26760,28961,1745
SOCO,"9/15/2024 2 p.m. CDT",27744,27220,29684,1940
SOCO,"9/15/2024 3 p.m. CDT",28016,27547,30827,2811
SOCO,"9/15/2024 4 p.m. CDT",28534,28077,31379,2845
SOCO,"9/15/2024 5 p.m. CDT",28863,28549,31776,2913
SOCO,"9/15/2024 6 p.m. CDT",28798,28525,31528,2730
SOCO,"9/15/2024 7 p.m. CDT",28720,28364,31024,2304
SOCO,"9/15/2024 8 p.m. CDT",28844,28433,30809,1965
SOCO,"9/15/2024 9 p.m. CDT",27878,27462,29461,1583
SOCO,"9/15/2024 10 p.m. CDT",26338,25963,27708,1370
SOCO,"9/15/2024 11 p.m. CDT",25019,24282,26183,1164
SOCO,"9/16/2024 12 a.m. CDT",23947,22848,24859,912
SOCO,"9/16/2024 1 a.m. CDT",22882,21651,23661,779
SOCO,"9/16/2024 2 a.m. CDT",22337,20896,23235,898
SOCO,"9/16/2024 3 a.m. CDT",22010,20582,22891,881
SOCO,"9/16/2024 4 a.m. CDT",22023,20602,22885,862
SOCO,"9/16/2024 5 a.m. CDT",22358,21397,23295,937
SOCO,"9/16/2024 6 a.m. CDT",23634,22960,24409,775
SOCO,"9/16/2024 7 a.m. CDT",24309,24104,25323,1014
SOCO,"9/16/2024 8 a.m. CDT",24814,24641,26092,1278
SOCO,"9/16/2024 9 a.m. CDT",25729,25678,27274,1545
SOCO,"9/16/2024 10 a.m. CDT",26888,26778,28470,1582
SOCO,"9/16/2024 11 a.m. CDT",28069,27897,29845,1776
SOCO,"9/16/2024 12 p.m. CDT",29293,29109,31084,1791
SOCO,"9/16/2024 1 p.m. CDT",30288,30108,31956,1668
SOCO,"9/16/2024 2 p.m. CDT",31162,30999,32857,1695
SOCO,"9/16/2024 3 p.m. CDT",31759,31538,33598,1839
SOCO,"9/16/2024 4 p.m. CDT",32026,31834,33927,1901
SOCO,"9/16/2024 5 p.m. CDT",31991,31816,33985,1994
SOCO,"9/16/2024 6 p.m. CDT",31358,31214,33249,1891
SOCO,"9/16/2024 7 p.m. CDT",30641,30449,32431,1790
SOCO,"9/16/2024 8 p.m. CDT",30257,30051,31948,1691
SOCO,"9/16/2024 9 p.m. CDT",28705,28473,30539,1834
SOCO,"9/16/2024 10 p.m. CDT",26725,26466,28400,1675
SOCO,"9/16/2024 11 p.m. CDT",24978,24487,25839,861
SOCO,"9/17/2024 12 a.m. CDT",23928,22744,24517,589
SOCO,"9/17/2024 1 a.m. CDT",22914,21525,23491,577
SOCO,"9/17/2024 2 a.m. CDT",22111,20716,22657,546
SOCO,"9/17/2024 3 a.m. CDT",21731,20337,22074,343
SOCO,"9/17/2024 4 a.m. CDT",21755,20345,22027,272
SOCO,"9/17/2024 5 a.m. CDT",22748,21010,22988,240
SOCO,"9/17/2024 6 a.m. CDT",23794,22409,23994,200
SOCO,"9/17/2024 7 a.m. CDT",24391,23513,25144,753
SOCO,"9/17/2024 8 a.m. CDT",24436,23913,25651,1215
SOCO,"9/17/2024 9 a.m. CDT",25026,24760,26310,1284
SOCO,"9/17/2024 10 a.m. CDT",26175,25934,27345,1170
SOCO,"9/17/2024 11 a.m. CDT",27453,27192,28650,1197
SOCO,"9/17/2024 12 p.m. CDT",28731,28464,29951,1220
SOCO,"9/17/2024 1 p.m. CDT",30138,29855,31333,1195
SOCO,"9/17/2024 2 p.m. CDT",31266,31003,32671,1405
SOCO,"9/17/2024 3 p.m. CDT",31998,31706,33784,1786
SOCO,"9/17/2024 4 p.m. CDT",32372,32079,34077,1705
SOCO,"9/17/2024 5 p.m. CDT",32304,32137,34058,1754
SOCO,"9/17/2024 6 p.m. CDT",31616,31504,33038,1422
SOCO,"9/17/2024 7 p.m. CDT",30982,30848,32444,1462
SOCO,"9/17/2024 8 p.m. CDT",30652,30390,31929,1277
SOCO,"9/17/2024 9 p.m. CDT",29313,29078,30672,1359
SOCO,"9/17/2024 10 p.m. CDT",27510,27151,28618,1108
SOCO,"9/17/2024 11 p.m. CDT",25759,25282,26287,528
SOCO,"9/18/2024 12 a.m. CDT",24800,23704,25306,506
SOCO,"9/18/2024 1 a.m. CDT",24229,22483,24435,206
SOCO,"9/18/2024 2 a.m. CDT",23489,21689,23770,281
SOCO,"9/18/2024 3 a.m. CDT",23034,21246,23155,121
SOCO,"9/18/2024 4 a.m. CDT",22938,21156,22898,-40
SOCO,"9/18/2024 5 a.m. CDT",23686,21902,23606,-80
SOCO,"9/18/2024 6 a.m. CDT",24398,23278,24595,197
SOCO,"9/18/2024 7 a.m. CDT",24807,24350,24973,166
SOCO,"9/18/2024 8 a.m. CDT",25130,24789,25783,653
SOCO,"9/18/2024 9 a.m. CDT",26009,25621,26764,755
SOCO,"9/18/2024 10 a.m. CDT",27262,26864,28086,824
SOCO,"9/18/2024 11 a.m. CDT",28658,28385,29570,912
SOCO,"9/18/2024 12 p.m. CDT",30409,30109,31371,962
SOCO,"9/18/2024 1 p.m. CDT",31952,31690,33246,1294
SOCO,"9/18/2024 2 p.m. CDT",33137,32834,34707,1570
SOCO,"9/18/2024 3 p.m. CDT",33992,33689,36452,2460
SOCO,"9/18/2024 4 p.m. CDT",34299,34059,36482,2183
SOCO,"9/18/2024 5 p.m. CDT",34037,33829,36161,2124
SOCO,"9/18/2024 6 p.m. CDT",33447,33268,35325,1878
SOCO,"9/18/2024 7 p.m. CDT",32469,32272,34150,1681
SOCO,"9/18/2024 8 p.m. CDT",31701,31485,33366,1665
SOCO,"9/18/2024 9 p.m. CDT",30324,30089,31792,1468
SOCO,"9/18/2024 10 p.m. CDT",28274,27921,29534,1260
SOCO,"9/18/2024 11 p.m. CDT",26326,25883,27053,727
SOCO,"9/19/2024 12 a.m. CDT",24871,24034,25072,201
SOCO,"9/19/2024 1 a.m. CDT",24017,22712,23950,-67
SOCO,"9/19/2024 2 a.m. CDT",23538,21844,23621,83
SOCO,"9/19/2024 3 a.m. CDT",22929,21255,23023,94
SOCO,"9/19/2024 4 a.m. CDT",22832,21191,22989,157
SOCO,"9/19/2024 5 a.m. CDT",23146,21836,23255,109
SOCO,"9/19/2024 6 a.m. CDT",24140,23259,24271,131
SOCO,"9/19/2024 7 a.m. CDT",24754,24288,25285,531
SOCO,"9/19/2024 8 a.m. CDT",25323,24839,26113,790
SOCO,"9/19/2024 9 a.m. CDT",26665,26142,27546,881
SOCO,"9/19/2024 10 a.m. CDT",28436,27887,29178,742
SOCO,"9/19/2024 11 a.m. CDT",30421,29904,31379,958
SOCO,"9/19/2024 12 p.m. CDT",32178,31921,33369,1191
SOCO,"9/19/2024 1 p.m. CDT",34035,33688,35276,1241
SOCO,"9/19/2024 2 p.m. CDT",35317,34983,37068,1751
SOCO,"9/19/2024 3 p.m. CDT",36149,35848,38713,2564
SOCO,"9/19/2024 4 p.m. CDT",36576,36241,38919,2343
SOCO,"9/19/2024 5 p.m. CDT",36580,36296,38970,2390
SOCO,"9/19/2024 6 p.m. CDT",35607,35345,37850,2243
SOCO,"9/19/2024 7 p.m. CDT",34092,33845,36186,2094
SOCO,"9/19/2024 8 p.m. CDT",32641,32864,34420,1779
SOCO,"9/19/2024 9 p.m. CDT",31246,30945,32555,1309
SOCO,"9/19/2024 10 p.m. CDT",29129,28698,30099,970
SOCO,"9/19/2024 11 p.m. CDT",26914,26597,27116,202
SOCO,"9/20/2024 12 a.m. CDT",25071,24766,25251,180
SOCO,"9/20/2024 1 a.m. CDT",24626,23283,24581,-45
SOCO,"9/20/2024 2 a.m. CDT",23800,22275,23896,96
SOCO,"9/20/2024 3 a.m. CDT",23175,21563,23278,103
SOCO,"9/20/2024 4 a.m. CDT",23006,21386,23028,22
SOCO,"9/20/2024 5 a.m. CDT",23499,21884,23545,46
SOCO,"9/20/2024 6 a.m. CDT",24283,23118,24386,103
SOCO,"9/20/2024 7 a.m. CDT",24576,24087,25267,691
SOCO,"9/20/2024 8 a.m. CDT",25059,24637,26170,1111
SOCO,"9/20/2024 9 a.m. CDT",26750,26263,28023,1273
SOCO,"9/20/2024 10 a.m. CDT",28782,28257,30215,1433
SOCO,"9/20/2024 11 a.m. CDT",31029,30784,32706,1677
SOCO,"9/20/2024 12 p.m. CDT",33569,33339,35603,2034
SOCO,"9/20/2024 1 p.m. CDT",35864,35514,37830,1966
SOCO,"9/20/2024 2 p.m. CDT",37399,37002,39708,2309
SOCO,"9/20/2024 3 p.m. CDT",38260,37786,40311,2051
SOCO,"9/20/2024 4 p.m. CDT",38679,38223,40605,1926
SOCO,"9/20/2024 5 p.m. CDT",38393,38003,40228,1835
SOCO,"9/20/2024 6 p.m. CDT",36956,36642,38602,1646
SOCO,"9/20/2024 7 p.m. CDT",34853,34423,36561,1708
SOCO,"9/20/2024 8 p.m. CDT",33124,32650,34395,1271
SOCO,"9/20/2024 9 p.m. CDT",31142,30827,32533,1391
SOCO,"9/20/2024 10 p.m. CDT",29066,28870,30103,1037
SOCO,"9/20/2024 11 p.m. CDT",27316,26883,27292,-24
SOCO,"9/21/2024 12 a.m. CDT",25503,24939,25558,55
SOCO,"9/21/2024 1 a.m. CDT",24256,23337,24446,190
SOCO,"9/21/2024 2 a.m. CDT",23453,22173,23529,76
SOCO,"9/21/2024 3 a.m. CDT",23116,21467,23432,316
SOCO,"9/21/2024 4 a.m. CDT",22694,21060,23145,451
SOCO,"9/21/2024 5 a.m. CDT",22556,20928,22983,427
SOCO,"9/21/2024 6 a.m. CDT",22392,21142,22984,592
SOCO,"9/21/2024 7 a.m. CDT",22550,21435,23199,649
SOCO,"9/21/2024 8 a.m. CDT",23644,22470,24582,938
SOCO,"9/21/2024 9 a.m. CDT",25447,24602,26294,847
SOCO,"9/21/2024 10 a.m. CDT",27212,26957,28229,1017
SOCO,"9/21/2024 11 a.m. CDT",30134,29829,31068,934
SOCO,"9/21/2024 12 p.m. CDT",32963,32683,34388,1425
SOCO,"9/21/2024 1 p.m. CDT",35271,34859,36723,1452
SOCO,"9/21/2024 2 p.m. CDT",36752,36337,38103,1351
SOCO,"9/21/2024 3 p.m. CDT",37773,37490,39561,1788
SOCO,"9/21/2024 4 p.m. CDT",38191,37824,40142,1951
SOCO,"9/21/2024 5 p.m. CDT",37997,37527,39493,1496
SOCO,"9/21/2024 6 p.m. CDT",36745,36319,38105,1360
SOCO,"9/21/2024 7 p.m. CDT",34577,34181,35933,1356
SOCO,"9/21/2024 8 p.m. CDT",33198,32784,34459,1261
SOCO,"9/21/2024 9 p.m. CDT",31142,30812,32712,1570
SOCO,"9/21/2024 10 p.m. CDT",29122,28717,30386,1264
SOCO,"9/21/2024 11 p.m. CDT",27229,26801,27886,657
SOCO,"9/22/2024 12 a.m. CDT",25463,25058,25877,414
SOCO,"9/22/2024 1 a.m. CDT",24270,23477,24592,322
SOCO,"9/22/2024 2 a.m. CDT",23473,22300,23811,338
SOCO,"9/22/2024 3 a.m. CDT",22693,21345,23333,640
SOCO,"9/22/2024 4 a.m. CDT",22207,20873,22953,746
SOCO,"9/22/2024 5 a.m. CDT",22034,20711,22852,818
SOCO,"9/22/2024 6 a.m. CDT",22155,20840,23084,929
SOCO,"9/22/2024 7 a.m. CDT",22086,20963,22928,842
SOCO,"9/22/2024 8 a.m. CDT",23326,22173,24436,1110
SOCO,"9/22/2024 9 a.m. CDT",25223,24377,26175,952
SOCO,"9/22/2024 10 a.m. CDT",27342,27066,28425,1083
SOCO,"9/22/2024 11 a.m. CDT",30471,30163,31074,603
SOCO,"9/22/2024 12 p.m. CDT",33511,33207,33915,404
SOCO,"9/22/2024 1 p.m. CDT",36122,35788,36842,720
SOCO,"9/22/2024 2 p.m. CDT",37679,37339,38324,645
SOCO,"9/22/2024 3 p.m. CDT",38874,38446,39242,368
SOCO,"9/22/2024 4 p.m. CDT",39244,38814,39855,611
SOCO,"9/22/2024 5 p.m. CDT",39205,38756,39416,211
SOCO,"9/22/2024 6 p.m. CDT",38196,37792,38138,-58
SOCO,"9/22/2024 7 p.m. CDT",36531,36240,37059,528
SOCO,"9/22/2024 8 p.m. CDT",35258,34989,36091,833
SOCO,"9/22/2024 9 p.m. CDT",32977,32692,33829,852
SOCO,"9/22/2024 10 p.m. CDT",30691,30383,31368,677
SOCO,"9/22/2024 11 p.m. CDT",28586,28111,28733,147
SOCO,"9/23/2024 12 a.m. CDT",26837,26046,27061,224
SOCO,"9/23/2024 1 a.m. CDT",25711,24430,26080,369
SOCO,"9/23/2024 2 a.m. CDT",24560,23281,25075,515
SOCO,"9/23/2024 3 a.m. CDT",23909,22624,24666,757
SOCO,"9/23/2024 4 a.m. CDT",23810,22531,24413,603
SOCO,"9/23/2024 5 a.m. CDT",24359,23079,24853,494
SOCO,"9/23/2024 6 a.m. CDT",25583,24469,25922,339
SOCO,"9/23/2024 7 a.m. CDT",25966,25508,26681,715
SOCO,"9/23/2024 8 a.m. CDT",26646,26217,27606,960
SOCO,"9/23/2024 9 a.m. CDT",28410,27928,29449,1039
SOCO,"9/23/2024 10 a.m. CDT",30564,30304,31472,908
SOCO,"9/23/2024 11 a.m. CDT",33537,33288,34754,1217
SOCO,"9/23/2024 12 p.m. CDT",36520,36154,38254,1734
SOCO,"9/23/2024 1 p.m. CDT",38868,38503,40456,1588
SOCO,"9/23/2024 2 p.m. CDT",40406,40010,41666,1260
SOCO,"9/23/2024 3 p.m. CDT",41208,40889,42184,976
SOCO,"9/23/2024 4 p.m. CDT",41384,41087,42164,780
SOCO,"9/23/2024 5 p.m. CDT",40999,40683,41840,841
SOCO,"9/23/2024 6 p.m. CDT",39594,39326,39936,342
SOCO,"9/23/2024 7 p.m. CDT",38191,37944,38365,174
SOCO,"9/23/2024 8 p.m. CDT",36766,36455,37277,511
SOCO,"9/23/2024 9 p.m. CDT",34394,34122,35362,968
SOCO,"9/23/2024 10 p.m. CDT",31744,31568,32669,925
SOCO,"9/23/2024 11 p.m. CDT",29450,29021,29905,455
SOCO,"9/24/2024 12 a.m. CDT",27774,26957,28062,288
SOCO,"9/24/2024 1 a.m. CDT",26596,25310,26849,253
SOCO,"9/24/2024 2 a.m. CDT",25583,24298,25860,277
SOCO,"9/24/2024 3 a.m. CDT",24929,23651,25233,304
SOCO,"9/24/2024 4 a.m. CDT",24627,23498,25110,483
SOCO,"9/24/2024 5 a.m. CDT",25300,24156,25822,522
SOCO,"9/24/2024 6 a.m. CDT",26308,25514,27070,762
SOCO,"9/24/2024 7 a.m. CDT",26814,26507,27896,1082
SOCO,"9/24/2024 8 a.m. CDT",27321,27045,28754,1433
SOCO,"9/24/2024 9 a.m. CDT",28572,28376,29794,1222
SOCO,"9/24/2024 10 a.m. CDT",30491,30253,31527,1036
SOCO,"9/24/2024 11 a.m. CDT",32852,32627,33993,1141
SOCO,"9/24/2024 12 p.m. CDT",35270,34933,35930,660
SOCO,"9/24/2024 1 p.m. CDT",37456,37101,37797,341
SOCO,"9/24/2024 2 p.m. CDT",38880,38504,39928,1048
SOCO,"9/24/2024 3 p.m. CDT",39675,39310,40618,943
SOCO,"9/24/2024 4 p.m. CDT",40139,39761,41030,891
SOCO,"9/24/2024 5 p.m. CDT",39718,39403,40150,432
SOCO,"9/24/2024 6 p.m. CDT",38564,38260,38669,105
SOCO,"9/24/2024 7 p.m. CDT",37081,36825,37012,-69
SOCO,"9/24/2024 8 p.m. CDT",35829,35581,35726,-103
SOCO,"9/24/2024 9 p.m. CDT",33717,33510,33978,261
SOCO,"9/24/2024 10 p.m. CDT",31369,31069,32291,922
SOCO,"9/24/2024 11 p.m. CDT",29152,28823,29470,318
SOCO,"9/25/2024 12 a.m. CDT",27429,26734,27628,199
SOCO,"9/25/2024 1 a.m. CDT",26266,25084,26190,-76
SOCO,"9/25/2024 2 a.m. CDT",25295,24082,25328,33
SOCO,"9/25/2024 3 a.m. CDT",24583,23379,24865,282
SOCO,"9/25/2024 4 a.m. CDT",24317,23167,24568,251
SOCO,"9/25/2024 5 a.m. CDT",24817,23736,25061,244
SOCO,"9/25/2024 6 a.m. CDT",25598,25150,26089,491
SOCO,"9/25/2024 7 a.m. CDT",26201,26112,27046,845
SOCO,"9/25/2024 8 a.m. CDT",26722,26606,27624,902
SOCO,"9/25/2024 9 a.m. CDT",27810,27647,28651,841
SOCO,"9/25/2024 10 a.m. CDT",29387,29197,30557,1170
SOCO,"9/25/2024 11 a.m. CDT",30873,30693,32242,1369
SOCO,"9/25/2024 12 p.m. CDT",31911,31723,33301,1390
SOCO,"9/25/2024 1 p.m. CDT",32649,32414,33541,892
SOCO,"9/25/2024 2 p.m. CDT",32348,32071,33002,654
SOCO,"9/25/2024 3 p.m. CDT",31847,31571,32806,959
SOCO,"9/25/2024 4 p.m. CDT",31467,31191,32783,1316
SOCO,"9/25/2024 5 p.m. CDT",31092,30803,32179,1087
SOCO,"9/25/2024 6 p.m. CDT",30419,30156,31860,1441
SOCO,"9/25/2024 7 p.m. CDT",29946,29766,31602,1656
SOCO,"9/25/2024 8 p.m. CDT",29467,29233,30963,1496
SOCO,"9/25/2024 9 p.m. CDT",28287,28087,30114,1827
SOCO,"9/25/2024 10 p.m. CDT",26950,26484,28497,1547
SOCO,"9/25/2024 11 p.m. CDT",25315,24877,25858,543
SOCO,"9/26/2024 12 a.m. CDT",24439,23379,24436,-3
SOCO,"9/26/2024 1 a.m. CDT",23262,22346,23726,464
SOCO,"9/26/2024 2 a.m. CDT",22505,21651,22921,416
SOCO,"9/26/2024 3 a.m. CDT",22116,21253,22545,429
SOCO,"9/26/2024 4 a.m. CDT",22145,21278,22667,522
SOCO,"9/26/2024 5 a.m. CDT",22640,21782,23103,463
SOCO,"9/26/2024 6 a.m. CDT",23569,23022,23865,296
SOCO,"9/26/2024 7 a.m. CDT",24484,24300,24916,432
SOCO,"9/26/2024 8 a.m. CDT",25167,24970,25635,468
SOCO,"9/26/2024 9 a.m. CDT",25890,25712,26361,471
SOCO,"9/26/2024 10 a.m. CDT",26445,26259,27231,786
SOCO,"9/26/2024 11 a.m. CDT",27123,26918,28149,1026
SOCO,"9/26/2024 12 p.m. CDT",27549,27332,28640,1091
SOCO,"9/26/2024 1 p.m. CDT",27827,27503,28978,1151
SOCO,"9/26/2024 2 p.m. CDT",27880,27574,28867,987
SOCO,"9/26/2024 3 p.m. CDT",27846,27645,29109,1263
SOCO,"9/26/2024 4 p.m. CDT",27919,27858,29271,1352
SOCO,"9/26/2024 5 p.m. CDT",27857,27599,29454,1597
SOCO,"9/26/2024 6 p.m. CDT",27698,27548,29448,1750
SOCO,"9/26/2024 7 p.m. CDT",27672,27544,29188,1516
SOCO,"9/26/2024 8 p.m. CDT",27359,27145,28712,1353
SOCO,"9/26/2024 9 p.m. CDT",26416,26179,27440,1024
SOCO,"9/26/2024 10 p.m. CDT",25166,24985,26026,860
SOCO,"9/26/2024 11 p.m. CDT",23734,23567,24038,304
SOCO,"9/27/2024 12 a.m. CDT",22762,21968,23200,438
SOCO,"9/27/2024 1 a.m. CDT",21445,20582,22089,644
SOCO,"9/27/2024 2 a.m. CDT",20385,19513,21151,766
SOCO,"9/27/2024 3 a.m. CDT",19454,18613,20153,699
SOCO,"9/27/2024 4 a.m. CDT",19017,18158,19989,972
SOCO,"9/27/2024 5 a.m. CDT",18509,17832,19540,1031
SOCO,"9/27/2024 6 a.m. CDT",18585,18083,19720,1135
SOCO,"9/27/2024 7 a.m. CDT",18669,18518,19835,1166
SOCO,"9/27/2024 8 a.m. CDT",18946,18778,20365,1419
SOCO,"9/27/2024 9 a.m. CDT",19753,19550,21020,1267
SOCO,"9/27/2024 10 a.m. CDT",20598,20352,21637,1039
SOCO,"9/27/2024 11 a.m. CDT",21375,21113,22418,1043
SOCO,"9/27/2024 12 p.m. CDT",22100,21850,23242,1142
SOCO,"9/27/2024 1 p.m. CDT",22700,22521,23919,1219
SOCO,"9/27/2024 2 p.m. CDT",23428,23262,24772,1344
SOCO,"9/27/2024 3 p.m. CDT",24080,23919,25418,1338
SOCO,"9/27/2024 4 p.m. CDT",24353,24193,25838,1485
SOCO,"9/27/2024 5 p.m. CDT",24297,24130,25681,1384
SOCO,"9/27/2024 6 p.m. CDT",23760,23714,25248,1488
SOCO,"9/27/2024 7 p.m. CDT",23346,23315,24865,1519
SOCO,"9/27/2024 8 p.m. CDT",23081,23010,24363,1282
SOCO,"9/27/2024 9 p.m. CDT",22259,22175,23288,1029
SOCO,"9/27/2024 10 p.m. CDT",21330,21259,22279,949
SOCO,"9/27/2024 11 p.m. CDT",20146,20090,20997,851
SOCO,"9/28/2024 12 a.m. CDT",19039,18984,19900,861
SOCO,"9/28/2024 1 a.m. CDT",18438,18023,18944,506
SOCO,"9/28/2024 2 a.m. CDT",17738,17302,18163,425
SOCO,"9/28/2024 3 a.m. CDT",17254,16744,17776,522
SOCO,"9/28/2024 4 a.m. CDT",17047,16551,17641,594
SOCO,"9/28/2024 5 a.m. CDT",17007,16525,17619,612
SOCO,"9/28/2024 6 a.m. CDT",17305,16785,18018,713
SOCO,"9/28/2024 7 a.m. CDT",17762,17236,18504,742
SOCO,"9/28/2024 8 a.m. CDT",18589,17828,19415,826
SOCO,"9/28/2024 9 a.m. CDT",19921,18857,20914,993
SOCO,"9/28/2024 10 a.m. CDT",21224,20070,22243,1019
SOCO,"9/28/2024 11 a.m. CDT",22483,21313,23489,1006
SOCO,"9/28/2024 12 p.m. CDT",23151,22348,24047,896
SOCO,"9/28/2024 1 p.m. CDT",23986,23251,24818,832
SOCO,"9/28/2024 2 p.m. CDT",24553,23849,25355,802
SOCO,"9/28/2024 3 p.m. CDT",24924,24287,25770,846
SOCO,"9/28/2024 4 p.m. CDT",25046,24491,26044,998
SOCO,"9/28/2024 5 p.m. CDT",24921,24572,25939,1018
SOCO,"9/28/2024 6 p.m. CDT",24575,24414,25468,893
SOCO,"9/28/2024 7 p.m. CDT",24283,24157,25241,958
SOCO,"9/28/2024 8 p.m. CDT",23863,23681,24746,883
SOCO,"9/28/2024 9 p.m. CDT",23024,22833,23806,782
SOCO,"9/28/2024 10 p.m. CDT",21953,21780,22705,752
SOCO,"9/28/2024 11 p.m. CDT",20871,20721,21411,540
SOCO,"9/29/2024 12 a.m. CDT",20200,19732,20581,381
SOCO,"9/29/2024 1 a.m. CDT",19106,18587,19795,689
SOCO,"9/29/2024 2 a.m. CDT",18295,17766,18968,673
SOCO,"9/29/2024 3 a.m. CDT",17792,17300,18694,902
SOCO,"9/29/2024 4 a.m. CDT",17553,16925,18522,969
SOCO,"9/29/2024 5 a.m. CDT",17763,16920,18651,888
SOCO,"9/29/2024 6 a.m. CDT",17901,17067,18832,931
SOCO,"9/29/2024 7 a.m. CDT",18260,17426,19172,912
SOCO,"9/29/2024 8 a.m. CDT",19028,18144,20198,1170
SOCO,"9/29/2024 9 a.m. CDT",19878,19576,21053,1175
SOCO,"9/29/2024 10 a.m. CDT",21361,21074,22714,1353
SOCO,"9/29/2024 11 a.m. CDT",22762,22478,24139,1377
SOCO,"9/29/2024 12 p.m. CDT",24285,24001,25603,1318
SOCO,"9/29/2024 1 p.m. CDT",25496,25202,26807,1311
SOCO,"9/29/2024 2 p.m. CDT",26226,25944,27770,1544
SOCO,"9/29/2024 3 p.m. CDT",26598,26300,28362,1764
SOCO,"9/29/2024 4 p.m. CDT",26805,26577,28695,1890
SOCO,"9/29/2024 5 p.m. CDT",26882,26655,28723,1841
SOCO,"9/29/2024 6 p.m. CDT",26567,26405,28257,1690
SOCO,"9/29/2024 7 p.m. CDT",26421,26270,28075,1654
SOCO,"9/29/2024 8 p.m. CDT",26190,26071,27669,1479
SOCO,"9/29/2024 9 p.m. CDT",25124,24925,26097,973
SOCO,"9/29/2024 10 p.m. CDT",23583,23405,24483,900
SOCO,"9/29/2024 11 p.m. CDT",21913,21754,22648,735
SOCO,"9/30/2024 12 a.m. CDT",20741,20182,21447,706
SOCO,"9/30/2024 1 a.m. CDT",20028,19108,20929,901
SOCO,"9/30/2024 2 a.m. CDT",19318,18415,20205,887
SOCO,"9/30/2024 3 a.m. CDT",18943,18059,19873,930
SOCO,"9/30/2024 4 a.m. CDT",18960,18085,19916,956
SOCO,"9/30/2024 5 a.m. CDT",19541,18652,20689,1148
SOCO,"9/30/2024 6 a.m. CDT",20713,20009,22143,1430
SOCO,"9/30/2024 7 a.m. CDT",21264,21118,22672,1408
SOCO,"9/30/2024 8 a.m. CDT",21948,21730,23250,1302
SOCO,"9/30/2024 9 a.m. CDT",23095,22816,24373,1278
SOCO,"9/30/2024 10 a.m. CDT",24393,24076,25940,1547
SOCO,"9/30/2024 11 a.m. CDT",25851,25499,27491,1640
SOCO,"9/30/2024 12 p.m. CDT",27271,26910,29187,1916
SOCO,"9/30/2024 1 p.m. CDT",28417,28003,30354,1937
SOCO,"9/30/2024 2 p.m. CDT",29234,28829,31372,2138
SOCO,"9/30/2024 3 p.m. CDT",29813,29409,31980,2167
SOCO,"9/30/2024 4 p.m. CDT",30051,29727,32482,2431
SOCO,"9/30/2024 5 p.m. CDT",30005,29722,32729,2724
SOCO,"9/30/2024 6 p.m. CDT",29502,29235,32154,2652
SOCO,"9/30/2024 7 p.m. CDT",29136,28913,31656,2520
SOCO,"9/30/2024 8 p.m. CDT",28735,28480,30616,1881
SOCO,"9/30/2024 9 p.m. CDT",27459,27056,28862,1403
SOCO,"9/30/2024 10 p.m. CDT",25602,25242,27064,1462
SOCO,"9/30/2024 11 p.m. CDT",23685,23319,25174,1489
SOCO,"10/1/2024 12 a.m. CDT",22377,21657,23514,1137
