"BA Code","Timestamp (Hour Ending)","Demand (MWh)","Demand Forecast (MWh)","Net Generation (MWh)","Total Interchange (MWh)"
SOCO,"12/1/2024 12 a.m. CST",28395,28040,29821,1426
SOCO,"12/1/2024 1 a.m. CST",28470,28209,29631,1161
SOCO,"12/1/2024 2 a.m. CST",28575,28289,29599,1024
SOCO,"12/1/2024 3 a.m. CST",28763,28478,29510,747
SOCO,"12/1/2024 4 a.m. CST",29163,28944,29927,764
SOCO,"12/1/2024 5 a.m. CST",29743,29614,30771,1028
SOCO,"12/1/2024 6 a.m. CST",30764,30625,31923,1159
SOCO,"12/1/2024 7 a.m. CST",31794,31642,33131,1337
SOCO,"12/1/2024 8 a.m. CST",32247,32007,33642,1395
SOCO,"12/1/2024 9 a.m. CST",30837,30507,32053,1216
SOCO,"12/1/2024 10 a.m. CST",29032,28502,30450,1418
SOCO,"12/1/2024 11 a.m. CST",27904,26853,29307,1403
SOCO,"12/1/2024 12 p.m. CST",26728,25696,28073,1345
SOCO,"12/1/2024 1 p.m. CST",26226,24738,27735,1509
SOCO,"12/1/2024 2 p.m. CST",25657,24138,27169,1512
SOCO,"12/1/2024 3 p.m. CST",25240,23925,26963,1723
SOCO,"12/1/2024 4 p.m. CST",25254,24485,27264,2010
SOCO,"12/1/2024 5 p.m. CST",26156,25897,28242,2086
SOCO,"12/1/2024 6 p.m. CST",27983,27756,30282,2299
SOCO,"12/1/2024 7 p.m. CST",28744,28478,30881,2137
SOCO,"12/1/2024 8 p.m. CST",29046,28796,31121,2075
SOCO,"12/1/2024 9 p.m. CST",28889,28619,30930,2041
SOCO,"12/1/2024 10 p.m. CST",28253,28011,30170,1917
SOCO,"12/1/2024 11 p.m. CST",27414,27143,29463,2049
SOCO,"12/2/2024 12 a.m. CST",27099,26790,29223,2124
SOCO,"12/2/2024 1 a.m. CST",26847,26724,28984,2137
SOCO,"12/2/2024 2 a.m. CST",27095,26987,29142,2047
SOCO,"12/2/2024 3 a.m. CST",27636,27508,29502,1866
SOCO,"12/2/2024 4 a.m. CST",28649,28382,30473,1824
SOCO,"12/2/2024 5 a.m. CST",30469,30252,32627,2158
SOCO,"12/2/2024 6 a.m. CST",33207,32978,35191,1984
SOCO,"12/2/2024 7 a.m. CST",35112,34984,37029,1917
SOCO,"12/2/2024 8 a.m. CST",34941,34631,37116,2175
SOCO,"12/2/2024 9 a.m. CST",33241,32894,35630,2389
SOCO,"12/2/2024 10 a.m. CST",31745,31299,33727,1982
SOCO,"12/2/2024 11 a.m. CST",30965,29846,32314,1349
SOCO,"12/2/2024 12 p.m. CST",29953,28668,31023,1070
SOCO,"12/2/2024 1 p.m. CST",28950,27689,30059,1109
SOCO,"12/2/2024 2 p.m. CST",28122,26986,29758,1636
SOCO,"12/2/2024 3 p.m. CST",27751,26640,29507,1756
SOCO,"12/2/2024 4 p.m. CST",28099,27166,30113,2014
SOCO,"12/2/2024 5 p.m. CST",28903,28747,31363,2460
SOCO,"12/2/2024 6 p.m. CST",30903,30779,33351,2448
SOCO,"12/2/2024 7 p.m. CST",31671,31535,33814,2143
SOCO,"12/2/2024 8 p.m. CST",32078,31937,33748,1670
SOCO,"12/2/2024 9 p.m. CST",31997,31591,33690,1693
SOCO,"12/2/2024 10 p.m. CST",31067,30587,32924,1857
SOCO,"12/2/2024 11 p.m. CST",29976,29502,31826,1850
SOCO,"12/3/2024 12 a.m. CST",29555,28876,30612,1057
SOCO,"12/3/2024 1 a.m. CST",29418,28548,30532,1114
SOCO,"12/3/2024 2 a.m. CST",29555,28681,30776,1221
SOCO,"12/3/2024 3 a.m. CST",29844,29041,30669,825
SOCO,"12/3/2024 4 a.m. CST",30078,29720,30621,543
SOCO,"12/3/2024 5 a.m. CST",31663,31300,32361,698
SOCO,"12/3/2024 6 a.m. CST",34106,33730,34829,723
SOCO,"12/3/2024 7 a.m. CST",35858,35522,36729,871
SOCO,"12/3/2024 8 a.m. CST",35543,35186,37125,1582
SOCO,"12/3/2024 9 a.m. CST",34252,33933,35778,1526
SOCO,"12/3/2024 10 a.m. CST",32836,32476,34105,1269
SOCO,"12/3/2024 11 a.m. CST",32012,31181,33189,1177
SOCO,"12/3/2024 12 p.m. CST",31217,30035,32160,943
SOCO,"12/3/2024 1 p.m. CST",30294,29144,30966,672
SOCO,"12/3/2024 2 p.m. CST",29679,28506,30566,887
SOCO,"12/3/2024 3 p.m. CST",29062,28240,29881,819
SOCO,"12/3/2024 4 p.m. CST",29697,28918,30658,961
SOCO,"12/3/2024 5 p.m. CST",31224,30930,31652,428
SOCO,"12/3/2024 6 p.m. CST",33396,33160,33583,187
SOCO,"12/3/2024 7 p.m. CST",34319,34036,34748,429
SOCO,"12/3/2024 8 p.m. CST",34891,34596,35065,174
SOCO,"12/3/2024 9 p.m. CST",34854,34595,35250,396
SOCO,"12/3/2024 10 p.m. CST",34030,33720,34524,494
SOCO,"12/3/2024 11 p.m. CST",33523,32946,34079,556
SOCO,"12/4/2024 12 a.m. CST",33143,32595,33789,646
SOCO,"12/4/2024 1 a.m. CST",33516,32618,33912,396
SOCO,"12/4/2024 2 a.m. CST",33958,32902,34267,309
SOCO,"12/4/2024 3 a.m. CST",34387,33410,34319,-68
SOCO,"12/4/2024 4 a.m. CST",34685,34327,34751,66
SOCO,"12/4/2024 5 a.m. CST",36150,35813,36482,332
SOCO,"12/4/2024 6 a.m. CST",38688,38311,38573,-115
SOCO,"12/4/2024 7 a.m. CST",40210,39875,40384,174
SOCO,"12/4/2024 8 a.m. CST",39502,39102,39941,439
SOCO,"12/4/2024 9 a.m. CST",36710,36415,37659,949
SOCO,"12/4/2024 10 a.m. CST",33884,33616,35204,1320
SOCO,"12/4/2024 11 a.m. CST",32018,31335,33439,1421
SOCO,"12/4/2024 12 p.m. CST",30828,29629,32172,1344
SOCO,"12/4/2024 1 p.m. CST",29742,28564,31207,1465
SOCO,"12/4/2024 2 p.m. CST",28914,27747,30380,1466
SOCO,"12/4/2024 3 p.m. CST",28290,27328,29772,1482
SOCO,"12/4/2024 4 p.m. CST",28351,27716,29500,1149
SOCO,"12/4/2024 5 p.m. CST",29524,29225,30748,1224
SOCO,"12/4/2024 6 p.m. CST",30746,30452,32287,1541
SOCO,"12/4/2024 7 p.m. CST",30986,30649,32740,1754
SOCO,"12/4/2024 8 p.m. CST",30705,30333,32504,1799
SOCO,"12/4/2024 9 p.m. CST",29813,29457,31556,1743
SOCO,"12/4/2024 10 p.m. CST",28487,28137,30038,1551
SOCO,"12/4/2024 11 p.m. CST",27326,26689,28814,1488
SOCO,"12/5/2024 12 a.m. CST",26129,25423,27712,1583
SOCO,"12/5/2024 1 a.m. CST",25193,24487,26565,1372
SOCO,"12/5/2024 2 a.m. CST",24655,23963,25953,1298
SOCO,"12/5/2024 3 a.m. CST",24470,23769,25946,1476
SOCO,"12/5/2024 4 a.m. CST",24763,24060,26166,1403
SOCO,"12/5/2024 5 a.m. CST",25552,25018,27237,1685
SOCO,"12/5/2024 6 a.m. CST",27045,26695,28875,1830
SOCO,"12/5/2024 7 a.m. CST",28083,27933,30376,2293
SOCO,"12/5/2024 8 a.m. CST",28047,27896,30134,2087
SOCO,"12/5/2024 9 a.m. CST",27837,27611,29462,1625
SOCO,"12/5/2024 10 a.m. CST",27329,27042,28700,1371
SOCO,"12/5/2024 11 a.m. CST",26572,26303,27962,1390
SOCO,"12/5/2024 12 p.m. CST",26406,25733,27837,1431
SOCO,"12/5/2024 1 p.m. CST",26085,25425,27531,1446
SOCO,"12/5/2024 2 p.m. CST",25639,24999,27206,1567
SOCO,"12/5/2024 3 p.m. CST",25471,25012,26773,1302
SOCO,"12/5/2024 4 p.m. CST",25765,25523,27069,1304
SOCO,"12/5/2024 5 p.m. CST",27434,27172,29174,1740
SOCO,"12/5/2024 6 p.m. CST",29082,28890,30868,1786
SOCO,"12/5/2024 7 p.m. CST",29861,29614,31952,2091
SOCO,"12/5/2024 8 p.m. CST",30429,30174,32529,2100
SOCO,"12/5/2024 9 p.m. CST",30453,30187,32515,2062
SOCO,"12/5/2024 10 p.m. CST",29844,29576,32034,2190
SOCO,"12/5/2024 11 p.m. CST",29349,28962,31458,2109
SOCO,"12/6/2024 12 a.m. CST",28993,28213,30714,1721
SOCO,"12/6/2024 1 a.m. CST",29107,28552,30729,1622
SOCO,"12/6/2024 2 a.m. CST",29543,28998,31070,1527
SOCO,"12/6/2024 3 a.m. CST",30165,29497,31592,1427
SOCO,"12/6/2024 4 a.m. CST",31419,30710,32785,1366
SOCO,"12/6/2024 5 a.m. CST",33054,32348,34374,1320
SOCO,"12/6/2024 6 a.m. CST",35607,34991,37137,1530
SOCO,"12/6/2024 7 a.m. CST",37611,37052,39478,1867
SOCO,"12/6/2024 8 a.m. CST",37585,36917,39478,1893
SOCO,"12/6/2024 9 a.m. CST",36457,35759,38053,1596
SOCO,"12/6/2024 10 a.m. CST",34835,34297,36301,1466
SOCO,"12/6/2024 11 a.m. CST",33468,32701,34963,1495
SOCO,"12/6/2024 12 p.m. CST",32348,31114,33956,1608
SOCO,"12/6/2024 1 p.m. CST",31128,29908,32853,1725
SOCO,"12/6/2024 2 p.m. CST",29931,28942,31788,1857
SOCO,"12/6/2024 3 p.m. CST",29177,28534,31120,1943
SOCO,"12/6/2024 4 p.m. CST",29455,29043,31269,1814
SOCO,"12/6/2024 5 p.m. CST",31050,30824,32901,1851
SOCO,"12/6/2024 6 p.m. CST",32894,32634,34253,1359
SOCO,"12/6/2024 7 p.m. CST",33548,33235,34924,1376
SOCO,"12/6/2024 8 p.m. CST",33973,33682,35445,1472
SOCO,"12/6/2024 9 p.m. CST",33994,33688,35637,1643
SOCO,"12/6/2024 10 p.m. CST",33523,33213,35294,1771
SOCO,"12/6/2024 11 p.m. CST",33239,32658,34841,1602
SOCO,"12/7/2024 12 a.m. CST",32805,32197,34024,1219
SOCO,"12/7/2024 1 a.m. CST",32510,31849,33523,1013
SOCO,"12/7/2024 2 a.m. CST",32833,31862,33854,1021
SOCO,"12/7/2024 3 a.m. CST",32902,31918,34099,1197
SOCO,"12/7/2024 4 a.m. CST",33060,32340,34284,1224
SOCO,"12/7/2024 5 a.m. CST",33567,33125,34697,1130
SOCO,"12/7/2024 6 a.m. CST",34693,34211,36082,1389
SOCO,"12/7/2024 7 a.m. CST",35623,35144,37061,1438
SOCO,"12/7/2024 8 a.m. CST",36076,35576,37586,1510
SOCO,"12/7/2024 9 a.m. CST",34551,33990,36079,1528
SOCO,"12/7/2024 10 a.m. CST",32637,31988,34056,1419
SOCO,"12/7/2024 11 a.m. CST",31003,29988,32465,1462
SOCO,"12/7/2024 12 p.m. CST",29245,28154,30924,1679
SOCO,"12/7/2024 1 p.m. CST",27546,26503,29294,1748
SOCO,"12/7/2024 2 p.m. CST",26637,25592,28385,1748
SOCO,"12/7/2024 3 p.m. CST",25952,25072,27825,1873
SOCO,"12/7/2024 4 p.m. CST",25843,25242,27713,1870
SOCO,"12/7/2024 5 p.m. CST",26989,26617,29005,2016
SOCO,"12/7/2024 6 p.m. CST",28346,28078,30422,2076
SOCO,"12/7/2024 7 p.m. CST",28553,28294,30465,1912
SOCO,"12/7/2024 8 p.m. CST",29051,28776,30805,1754
SOCO,"12/7/2024 9 p.m. CST",29158,28768,30718,1560
SOCO,"12/7/2024 10 p.m. CST",28782,28371,29987,1205
SOCO,"12/7/2024 11 p.m. CST",28048,27656,28855,807
SOCO,"12/8/2024 12 a.m. CST",27460,27080,27880,420
SOCO,"12/8/2024 1 a.m. CST",27161,26806,27349,188
SOCO,"12/8/2024 2 a.m. CST",27005,26607,27291,286
SOCO,"12/8/2024 3 a.m. CST",27428,26699,27649,221
SOCO,"12/8/2024 4 a.m. CST",27366,26947,27624,258
SOCO,"12/8/2024 5 a.m. CST",27774,27393,28213,439
SOCO,"12/8/2024 6 a.m. CST",28476,28082,29103,627
SOCO,"12/8/2024 7 a.m. CST",29232,28812,30140,908
SOCO,"12/8/2024 8 a.m. CST",29641,29190,30557,916
SOCO,"12/8/2024 9 a.m. CST",29127,28656,29648,521
SOCO,"12/8/2024 10 a.m. CST",28075,27613,28577,502
SOCO,"12/8/2024 11 a.m. CST",27365,26525,27802,437
SOCO,"12/8/2024 12 p.m. CST",26802,25644,27413,611
SOCO,"12/8/2024 1 p.m. CST",26142,24958,26901,759
SOCO,"12/8/2024 2 p.m. CST",25758,24581,26638,880
SOCO,"12/8/2024 3 p.m. CST",25347,24210,26166,819
SOCO,"12/8/2024 4 p.m. CST",25150,24467,26011,861
SOCO,"12/8/2024 5 p.m. CST",25978,25583,27169,1191
SOCO,"12/8/2024 6 p.m. CST",27026,26621,28341,1315
SOCO,"12/8/2024 7 p.m. CST",27053,26638,28267,1214
SOCO,"12/8/2024 8 p.m. CST",26858,26470,28126,1268
SOCO,"12/8/2024 9 p.m. CST",26094,25711,27122,1028
SOCO,"12/8/2024 10 p.m. CST",24914,24555,25795,881
SOCO,"12/8/2024 11 p.m. CST",23611,23184,24297,686
SOCO,"12/9/2024 12 a.m. CST",22844,22144,23714,870
SOCO,"12/9/2024 1 a.m. CST",22050,21468,23157,1107
SOCO,"12/9/2024 2 a.m. CST",22107,21200,23175,1068
SOCO,"12/9/2024 3 a.m. CST",22019,21119,22888,869
SOCO,"12/9/2024 4 a.m. CST",22439,21516,23336,897
SOCO,"12/9/2024 5 a.m. CST",22947,22658,23950,1003
SOCO,"12/9/2024 6 a.m. CST",24711,24529,25634,923
SOCO,"12/9/2024 7 a.m. CST",26169,26051,27237,1068
SOCO,"12/9/2024 8 a.m. CST",26255,26080,27124,869
SOCO,"12/9/2024 9 a.m. CST",26365,26173,27291,926
SOCO,"12/9/2024 10 a.m. CST",26374,26180,27131,757
SOCO,"12/9/2024 11 a.m. CST",26205,25983,26882,677
SOCO,"12/9/2024 12 p.m. CST",25929,25717,26692,763
SOCO,"12/9/2024 1 p.m. CST",25722,25506,26420,698
SOCO,"12/9/2024 2 p.m. CST",25506,25264,26161,655
SOCO,"12/9/2024 3 p.m. CST",25425,25212,26160,735
SOCO,"12/9/2024 4 p.m. CST",25596,25350,26332,736
SOCO,"12/9/2024 5 p.m. CST",26659,26305,27912,1253
SOCO,"12/9/2024 6 p.m. CST",27131,26741,28372,1241
SOCO,"12/9/2024 7 p.m. CST",26902,26519,27921,1019
SOCO,"12/9/2024 8 p.m. CST",26348,26002,27228,880
SOCO,"12/9/2024 9 p.m. CST",25371,24990,26259,888
SOCO,"12/9/2024 10 p.m. CST",23880,23552,25042,1162
SOCO,"12/9/2024 11 p.m. CST",22737,22156,23794,1057
SOCO,"12/10/2024 12 a.m. CST",21906,20969,22996,1090
SOCO,"12/10/2024 1 a.m. CST",21197,20266,21826,629
SOCO,"12/10/2024 2 a.m. CST",20653,19750,21189,536
SOCO,"12/10/2024 3 a.m. CST",20532,19634,21125,593
SOCO,"12/10/2024 4 a.m. CST",20703,19813,21397,694
SOCO,"12/10/2024 5 a.m. CST",21156,20713,22018,862
SOCO,"12/10/2024 6 a.m. CST",22576,22383,23314,738
SOCO,"12/10/2024 7 a.m. CST",23991,23856,25208,1217
SOCO,"12/10/2024 8 a.m. CST",24181,23975,25535,1354
SOCO,"12/10/2024 9 a.m. CST",24548,24283,25897,1349
SOCO,"12/10/2024 10 a.m. CST",24786,24515,26219,1433
SOCO,"12/10/2024 11 a.m. CST",24947,24667,26384,1437
SOCO,"12/10/2024 12 p.m. CST",25009,24715,26189,1180
SOCO,"12/10/2024 1 p.m. CST",25098,24797,26330,1232
SOCO,"12/10/2024 2 p.m. CST",25029,24741,26450,1421
SOCO,"12/10/2024 3 p.m. CST",24995,24715,26439,1444
SOCO,"12/10/2024 4 p.m. CST",25054,24772,26677,1623
SOCO,"12/10/2024 5 p.m. CST",25827,25544,27413,1586
SOCO,"12/10/2024 6 p.m. CST",26380,26077,27967,1587
SOCO,"12/10/2024 7 p.m. CST",26208,25926,27673,1465
SOCO,"12/10/2024 8 p.m. CST",25833,25529,27347,1514
SOCO,"12/10/2024 9 p.m. CST",25007,24730,26488,1481
SOCO,"12/10/2024 10 p.m. CST",23747,23486,25085,1338
SOCO,"12/10/2024 11 p.m. CST",22490,22078,23439,949
SOCO,"12/11/2024 12 a.m. CST",21889,20939,22822,933
SOCO,"12/11/2024 1 a.m. CST",20988,20006,21832,844
SOCO,"12/11/2024 2 a.m. CST",20568,19604,21363,795
SOCO,"12/11/2024 3 a.m. CST",20432,19462,21285,853
SOCO,"12/11/2024 4 a.m. CST",20786,19828,21989,1203
SOCO,"12/11/2024 5 a.m. CST",21201,20768,22779,1578
SOCO,"12/11/2024 6 a.m. CST",23084,22810,24700,1616
SOCO,"12/11/2024 7 a.m. CST",25019,24788,27072,2053
SOCO,"12/11/2024 8 a.m. CST",25910,25633,28094,2184
SOCO,"12/11/2024 9 a.m. CST",26488,26210,28826,2338
SOCO,"12/11/2024 10 a.m. CST",26819,26561,29027,2208
SOCO,"12/11/2024 11 a.m. CST",26861,26590,29141,2280
SOCO,"12/11/2024 12 p.m. CST",26600,26358,28853,2253
SOCO,"12/11/2024 1 p.m. CST",26335,26063,28758,2423
SOCO,"12/11/2024 2 p.m. CST",26114,25841,28247,2133
SOCO,"12/11/2024 3 p.m. CST",26269,26007,28166,1897
SOCO,"12/11/2024 4 p.m. CST",27000,26709,28594,1594
SOCO,"12/11/2024 5 p.m. CST",28588,28394,30652,2064
SOCO,"12/11/2024 6 p.m. CST",30341,30093,32108,1767
SOCO,"12/11/2024 7 p.m. CST",31102,30766,32445,1343
SOCO,"12/11/2024 8 p.m. CST",31443,31145,32575,1132
SOCO,"12/11/2024 9 p.m. CST",31225,30917,32194,969
SOCO,"12/11/2024 10 p.m. CST",30450,29958,31253,803
SOCO,"12/11/2024 11 p.m. CST",29413,28977,30238,825
SOCO,"12/12/2024 12 a.m. CST",29262,28431,30046,784
SOCO,"12/12/2024 1 a.m. CST",29457,28264,30196,739
SOCO,"12/12/2024 2 a.m. CST",29607,28401,30137,530
SOCO,"12/12/2024 3 a.m. CST",30074,28880,30638,564
SOCO,"12/12/2024 4 a.m. CST",30494,29775,31109,615
SOCO,"12/12/2024 5 a.m. CST",31841,31475,32706,865
SOCO,"12/12/2024 6 a.m. CST",34442,34123,35199,757
SOCO,"12/12/2024 7 a.m. CST",36194,35972,36812,618
SOCO,"12/12/2024 8 a.m. CST",36022,35770,36692,670
SOCO,"12/12/2024 9 a.m. CST",34106,33783,35247,1141
SOCO,"12/12/2024 10 a.m. CST",32552,32037,33118,566
SOCO,"12/12/2024 11 a.m. CST",31406,30197,31971,565
SOCO,"12/12/2024 12 p.m. CST",29907,28704,30728,821
SOCO,"12/12/2024 1 p.m. CST",28851,27722,29598,747
SOCO,"12/12/2024 2 p.m. CST",28064,26951,28920,856
SOCO,"12/12/2024 3 p.m. CST",27674,26530,28785,1111
SOCO,"12/12/2024 4 p.m. CST",27775,26764,28925,1150
SOCO,"12/12/2024 5 p.m. CST",28757,28217,29973,1216
SOCO,"12/12/2024 6 p.m. CST",30302,30039,31541,1239
SOCO,"12/12/2024 7 p.m. CST",31113,30862,32313,1200
SOCO,"12/12/2024 8 p.m. CST",31720,31377,32699,979
SOCO,"12/12/2024 9 p.m. CST",31678,31417,32612,934
SOCO,"12/12/2024 10 p.m. CST",31033,30565,31875,842
SOCO,"12/12/2024 11 p.m. CST",30448,29849,31067,619
SOCO,"12/13/2024 12 a.m. CST",29965,29367,30423,458
SOCO,"12/13/2024 1 a.m. CST",29956,29212,30543,587
SOCO,"12/13/2024 2 a.m. CST",30217,29376,30783,566
SOCO,"12/13/2024 3 a.m. CST",30553,29729,31063,510
SOCO,"12/13/2024 4 a.m. CST",31391,30552,31926,535
SOCO,"12/13/2024 5 a.m. CST",32342,31862,33127,785
SOCO,"12/13/2024 6 a.m. CST",34622,34182,35671,1049
SOCO,"12/13/2024 7 a.m. CST",36157,35719,37143,986
SOCO,"12/13/2024 8 a.m. CST",35577,35108,36691,1114
SOCO,"12/13/2024 9 a.m. CST",33682,33261,34653,971
SOCO,"12/13/2024 10 a.m. CST",31409,31051,31976,567
SOCO,"12/13/2024 11 a.m. CST",29945,29272,30154,209
SOCO,"12/13/2024 12 p.m. CST",29017,27842,29122,105
SOCO,"12/13/2024 1 p.m. CST",28185,26739,28339,154
SOCO,"12/13/2024 2 p.m. CST",27606,26019,27856,250
SOCO,"12/13/2024 3 p.m. CST",27050,25631,27489,439
SOCO,"12/13/2024 4 p.m. CST",26849,25842,27264,415
SOCO,"12/13/2024 5 p.m. CST",27244,26903,27843,599
SOCO,"12/13/2024 6 p.m. CST",28030,27792,28451,421
SOCO,"12/13/2024 7 p.m. CST",28029,27794,28390,361
SOCO,"12/13/2024 8 p.m. CST",27946,27710,28156,210
SOCO,"12/13/2024 9 p.m. CST",27662,27366,27845,183
SOCO,"12/13/2024 10 p.m. CST",27216,26771,27358,142
SOCO,"12/13/2024 11 p.m. CST",26308,25885,26415,107
SOCO,"12/14/2024 12 a.m. CST",25499,25079,25694,195
SOCO,"12/14/2024 1 a.m. CST",25313,24540,25365,52
SOCO,"12/14/2024 2 a.m. CST",25382,24255,25304,-78
SOCO,"12/14/2024 3 a.m. CST",25185,24066,25133,-52
SOCO,"12/14/2024 4 a.m. CST",25268,24162,25415,147
SOCO,"12/14/2024 5 a.m. CST",25344,24596,25646,302
SOCO,"12/14/2024 6 a.m. CST",25598,25215,26149,551
SOCO,"12/14/2024 7 a.m. CST",26332,26066,27257,925
SOCO,"12/14/2024 8 a.m. CST",27089,26798,28370,1281
SOCO,"12/14/2024 9 a.m. CST",27230,26902,28289,1059
SOCO,"12/14/2024 10 a.m. CST",26603,26282,27325,722
SOCO,"12/14/2024 11 a.m. CST",25768,25429,26502,734
SOCO,"12/14/2024 12 p.m. CST",25272,24594,26204,932
SOCO,"12/14/2024 1 p.m. CST",24680,24012,25507,827
SOCO,"12/14/2024 2 p.m. CST",24408,23496,25170,762
SOCO,"12/14/2024 3 p.m. CST",24227,23234,25141,914
SOCO,"12/14/2024 4 p.m. CST",24105,23461,25291,1186
SOCO,"12/14/2024 5 p.m. CST",24588,24352,25852,1264
SOCO,"12/14/2024 6 p.m. CST",25408,25155,26959,1551
SOCO,"12/14/2024 7 p.m. CST",25314,25078,26690,1376
SOCO,"12/14/2024 8 p.m. CST",25191,24936,26469,1278
SOCO,"12/14/2024 9 p.m. CST",24679,24450,25785,1106
SOCO,"12/14/2024 10 p.m. CST",24060,23839,24953,893
SOCO,"12/14/2024 11 p.m. CST",23144,22946,23701,557
SOCO,"12/15/2024 12 a.m. CST",22284,22073,22866,582
SOCO,"12/15/2024 1 a.m. CST",21981,21427,22212,231
SOCO,"12/15/2024 2 a.m. CST",22010,21099,22267,257
SOCO,"12/15/2024 3 a.m. CST",21814,20912,22088,274
SOCO,"12/15/2024 4 a.m. CST",21890,20984,22166,276
SOCO,"12/15/2024 5 a.m. CST",21974,21445,22502,528
SOCO,"12/15/2024 6 a.m. CST",22635,22095,22913,278
SOCO,"12/15/2024 7 a.m. CST",23281,23056,24114,833
SOCO,"12/15/2024 8 a.m. CST",24291,24101,25411,1120
SOCO,"12/15/2024 9 a.m. CST",25263,25043,26274,1011
SOCO,"12/15/2024 10 a.m. CST",25480,25254,26313,833
SOCO,"12/15/2024 11 a.m. CST",25565,25329,26132,567
SOCO,"12/15/2024 12 p.m. CST",25505,25254,26094,589
SOCO,"12/15/2024 1 p.m. CST",25600,25181,26124,524
SOCO,"12/15/2024 2 p.m. CST",25646,25017,26266,620
SOCO,"12/15/2024 3 p.m. CST",25702,25106,26406,704
SOCO,"12/15/2024 4 p.m. CST",25800,25354,26426,626
SOCO,"12/15/2024 5 p.m. CST",26382,26139,27109,727
SOCO,"12/15/2024 6 p.m. CST",27238,26842,28272,1034
SOCO,"12/15/2024 7 p.m. CST",27339,26939,28142,803
SOCO,"12/15/2024 8 p.m. CST",26977,26578,27763,786
SOCO,"12/15/2024 9 p.m. CST",26305,25991,27001,696
SOCO,"12/15/2024 10 p.m. CST",25203,24921,26070,867
SOCO,"12/15/2024 11 p.m. CST",23822,23558,24601,779
SOCO,"12/16/2024 12 a.m. CST",23022,22553,23872,850
SOCO,"12/16/2024 1 a.m. CST",22880,21896,23488,608
SOCO,"12/16/2024 2 a.m. CST",22875,21613,23452,577
SOCO,"12/16/2024 3 a.m. CST",23050,21642,23628,578
SOCO,"12/16/2024 4 a.m. CST",23135,22113,23764,629
SOCO,"12/16/2024 5 a.m. CST",23694,23245,24226,532
SOCO,"12/16/2024 6 a.m. CST",25626,25397,26210,584
SOCO,"12/16/2024 7 a.m. CST",27140,26929,27819,679
SOCO,"12/16/2024 8 a.m. CST",27276,27041,28146,870
SOCO,"12/16/2024 9 a.m. CST",27219,26946,28271,1052
SOCO,"12/16/2024 10 a.m. CST",26878,26617,28111,1233
SOCO,"12/16/2024 11 a.m. CST",26396,26066,27653,1257
SOCO,"12/16/2024 12 p.m. CST",26150,25530,27286,1136
SOCO,"12/16/2024 1 p.m. CST",26097,25109,27319,1222
SOCO,"12/16/2024 2 p.m. CST",25818,24831,27072,1254
SOCO,"12/16/2024 3 p.m. CST",25421,24669,26827,1406
SOCO,"12/16/2024 4 p.m. CST",25233,24656,26675,1442
SOCO,"12/16/2024 5 p.m. CST",25727,25439,26840,1113
SOCO,"12/16/2024 6 p.m. CST",26828,26511,28028,1200
SOCO,"12/16/2024 7 p.m. CST",26853,26564,27935,1082
SOCO,"12/16/2024 8 p.m. CST",26576,26267,27513,937
SOCO,"12/16/2024 9 p.m. CST",25786,25506,26854,1068
SOCO,"12/16/2024 10 p.m. CST",24576,24332,25710,1134
SOCO,"12/16/2024 11 p.m. CST",23264,23095,24191,927
SOCO,"12/17/2024 12 a.m. CST",22572,21958,23287,715
SOCO,"12/17/2024 1 a.m. CST",21725,21169,22378,653
SOCO,"12/17/2024 2 a.m. CST",21752,20847,22445,693
SOCO,"12/17/2024 3 a.m. CST",21373,20808,22072,699
SOCO,"12/17/2024 4 a.m. CST",21750,21198,22486,736
SOCO,"12/17/2024 5 a.m. CST",22445,22257,23284,839
SOCO,"12/17/2024 6 a.m. CST",24318,24123,25371,1053
SOCO,"12/17/2024 7 a.m. CST",25708,25421,26759,1051
SOCO,"12/17/2024 8 a.m. CST",25883,25664,26921,1038
SOCO,"12/17/2024 9 a.m. CST",25523,25276,26599,1076
SOCO,"12/17/2024 10 a.m. CST",25205,24935,26603,1398
SOCO,"12/17/2024 11 a.m. CST",25298,24692,26715,1417
SOCO,"12/17/2024 12 p.m. CST",25193,24543,26464,1271
SOCO,"12/17/2024 1 p.m. CST",25483,24533,26649,1166
SOCO,"12/17/2024 2 p.m. CST",25535,24497,26524,989
SOCO,"12/17/2024 3 p.m. CST",25439,24446,26341,902
SOCO,"12/17/2024 4 p.m. CST",25387,24583,26256,869
SOCO,"12/17/2024 5 p.m. CST",25389,25171,26383,994
SOCO,"12/17/2024 6 p.m. CST",26264,26048,27319,1055
SOCO,"12/17/2024 7 p.m. CST",26216,25941,27203,987
SOCO,"12/17/2024 8 p.m. CST",25767,25495,26657,890
SOCO,"12/17/2024 9 p.m. CST",24979,24721,26285,1306
SOCO,"12/17/2024 10 p.m. CST",23810,23575,24839,1029
SOCO,"12/17/2024 11 p.m. CST",22507,22218,23011,504
SOCO,"12/18/2024 12 a.m. CST",21367,21077,21839,472
SOCO,"12/18/2024 1 a.m. CST",21229,20309,21621,392
SOCO,"12/18/2024 2 a.m. CST",21025,19868,21462,437
SOCO,"12/18/2024 3 a.m. CST",21098,19953,21660,562
SOCO,"12/18/2024 4 a.m. CST",21132,20343,21707,575
SOCO,"12/18/2024 5 a.m. CST",21745,21391,22232,487
SOCO,"12/18/2024 6 a.m. CST",23451,23206,24159,708
SOCO,"12/18/2024 7 a.m. CST",24849,24584,25660,811
SOCO,"12/18/2024 8 a.m. CST",25081,24824,26066,985
SOCO,"12/18/2024 9 a.m. CST",25089,24802,25990,901
SOCO,"12/18/2024 10 a.m. CST",25015,24715,26001,986
SOCO,"12/18/2024 11 a.m. CST",25156,24606,26159,1003
SOCO,"12/18/2024 12 p.m. CST",25071,24427,26110,1039
SOCO,"12/18/2024 1 p.m. CST",25192,24535,26607,1415
SOCO,"12/18/2024 2 p.m. CST",25193,24547,26665,1472
SOCO,"12/18/2024 3 p.m. CST",25068,24425,26753,1685
SOCO,"12/18/2024 4 p.m. CST",24870,24508,26599,1729
SOCO,"12/18/2024 5 p.m. CST",25273,25083,26939,1666
SOCO,"12/18/2024 6 p.m. CST",26019,25796,27740,1721
SOCO,"12/18/2024 7 p.m. CST",25858,25249,27430,1572
SOCO,"12/18/2024 8 p.m. CST",25442,24844,26858,1416
SOCO,"12/18/2024 9 p.m. CST",24780,24143,26125,1345
SOCO,"12/18/2024 10 p.m. CST",23767,22983,24784,1017
SOCO,"12/18/2024 11 p.m. CST",22599,22228,23141,542
SOCO,"12/19/2024 12 a.m. CST",21904,20710,22380,476
SOCO,"12/19/2024 1 a.m. CST",21648,20450,22419,771
SOCO,"12/19/2024 2 a.m. CST",21335,20119,22521,1186
SOCO,"12/19/2024 3 a.m. CST",21325,20104,22495,1170
SOCO,"12/19/2024 4 a.m. CST",21674,20557,22883,1209
SOCO,"12/19/2024 5 a.m. CST",22537,21709,23967,1430
SOCO,"12/19/2024 6 a.m. CST",23879,23672,25270,1391
SOCO,"12/19/2024 7 a.m. CST",25493,25351,27046,1553
SOCO,"12/19/2024 8 a.m. CST",26033,25812,27783,1750
SOCO,"12/19/2024 9 a.m. CST",26357,26129,28176,1819
SOCO,"12/19/2024 10 a.m. CST",26333,26072,28240,1907
SOCO,"12/19/2024 11 a.m. CST",25921,25638,27537,1616
SOCO,"12/19/2024 12 p.m. CST",25401,25088,27027,1626
SOCO,"12/19/2024 1 p.m. CST",25417,24760,26853,1436
SOCO,"12/19/2024 2 p.m. CST",25129,24475,26712,1583
SOCO,"12/19/2024 3 p.m. CST",25015,24373,26694,1679
SOCO,"12/19/2024 4 p.m. CST",24842,24419,26575,1733
SOCO,"12/19/2024 5 p.m. CST",25621,25438,26907,1286
SOCO,"12/19/2024 6 p.m. CST",26951,26758,27839,888
SOCO,"12/19/2024 7 p.m. CST",27545,27336,28480,935
SOCO,"12/19/2024 8 p.m. CST",27563,27356,28485,922
SOCO,"12/19/2024 9 p.m. CST",27387,27182,28090,703
SOCO,"12/19/2024 10 p.m. CST",26647,26412,27531,884
SOCO,"12/19/2024 11 p.m. CST",25948,25440,26584,636
SOCO,"12/20/2024 12 a.m. CST",25453,24824,25976,523
SOCO,"12/20/2024 1 a.m. CST",25727,24463,26506,779
SOCO,"12/20/2024 2 a.m. CST",25768,24477,26892,1124
SOCO,"12/20/2024 3 a.m. CST",26031,24761,27067,1036
SOCO,"12/20/2024 4 a.m. CST",26232,25449,27298,1066
SOCO,"12/20/2024 5 a.m. CST",27113,26825,28320,1207
SOCO,"12/20/2024 6 a.m. CST",29248,28931,30512,1264
SOCO,"12/20/2024 7 a.m. CST",31112,30863,32334,1222
SOCO,"12/20/2024 8 a.m. CST",31519,31183,32986,1467
SOCO,"12/20/2024 9 a.m. CST",30555,30199,32286,1731
SOCO,"12/20/2024 10 a.m. CST",29173,28767,30998,1825
SOCO,"12/20/2024 11 a.m. CST",28742,27609,30615,1873
SOCO,"12/20/2024 12 p.m. CST",27720,26392,29468,1748
SOCO,"12/20/2024 1 p.m. CST",26998,25702,28753,1755
SOCO,"12/20/2024 2 p.m. CST",26906,25292,28751,1845
SOCO,"12/20/2024 3 p.m. CST",26559,25097,28480,1921
SOCO,"12/20/2024 4 p.m. CST",26601,25633,28822,2221
SOCO,"12/20/2024 5 p.m. CST",27308,27067,29546,2238
SOCO,"12/20/2024 6 p.m. CST",28625,28467,30457,1832
SOCO,"12/20/2024 7 p.m. CST",29092,28923,30726,1634
SOCO,"12/20/2024 8 p.m. CST",29290,29141,30858,1568
SOCO,"12/20/2024 9 p.m. CST",29274,29092,30674,1400
SOCO,"12/20/2024 10 p.m. CST",29018,28832,30571,1553
SOCO,"12/20/2024 11 p.m. CST",28646,28138,29891,1245
SOCO,"12/21/2024 12 a.m. CST",28059,27566,29470,1411
SOCO,"12/21/2024 1 a.m. CST",28099,27167,29156,1057
SOCO,"12/21/2024 2 a.m. CST",28091,27153,29028,937
SOCO,"12/21/2024 3 a.m. CST",28230,27284,29104,874
SOCO,"12/21/2024 4 a.m. CST",28445,27771,29492,1047
SOCO,"12/21/2024 5 a.m. CST",28882,28546,30036,1154
SOCO,"12/21/2024 6 a.m. CST",30022,29708,30657,635
SOCO,"12/21/2024 7 a.m. CST",31330,31104,31934,604
SOCO,"12/21/2024 8 a.m. CST",32216,31877,32941,725
SOCO,"12/21/2024 9 a.m. CST",32105,31588,33078,973
SOCO,"12/21/2024 10 a.m. CST",31066,30562,32343,1277
SOCO,"12/21/2024 11 a.m. CST",30374,29230,31534,1160
SOCO,"12/21/2024 12 p.m. CST",28914,27687,30270,1356
SOCO,"12/21/2024 1 p.m. CST",27752,26561,29268,1516
SOCO,"12/21/2024 2 p.m. CST",26879,25710,28525,1646
SOCO,"12/21/2024 3 p.m. CST",26582,25445,28367,1785
SOCO,"12/21/2024 4 p.m. CST",26747,25836,28473,1726
SOCO,"12/21/2024 5 p.m. CST",27726,27317,29273,1547
SOCO,"12/21/2024 6 p.m. CST",29559,29224,31258,1699
SOCO,"12/21/2024 7 p.m. CST",30175,29933,31699,1524
SOCO,"12/21/2024 8 p.m. CST",30640,30353,31932,1292
SOCO,"12/21/2024 9 p.m. CST",30794,30576,32054,1260
SOCO,"12/21/2024 10 p.m. CST",30735,30403,31778,1043
SOCO,"12/21/2024 11 p.m. CST",30354,30044,31465,1111
SOCO,"12/22/2024 12 a.m. CST",30433,29762,31422,989
SOCO,"12/22/2024 1 a.m. CST",30838,29694,31791,953
SOCO,"12/22/2024 2 a.m. CST",31047,29852,31981,934
SOCO,"12/22/2024 3 a.m. CST",31110,30132,32031,921
SOCO,"12/22/2024 4 a.m. CST",31111,30641,32125,1014
SOCO,"12/22/2024 5 a.m. CST",31759,31348,32980,1221
SOCO,"12/22/2024 6 a.m. CST",32786,32423,33802,1016
SOCO,"12/22/2024 7 a.m. CST",34131,33818,35094,963
SOCO,"12/22/2024 8 a.m. CST",34867,34447,35673,806
SOCO,"12/22/2024 9 a.m. CST",33845,33413,34671,826
SOCO,"12/22/2024 10 a.m. CST",31860,31431,32687,827
SOCO,"12/22/2024 11 a.m. CST",30766,29445,31330,564
SOCO,"12/22/2024 12 p.m. CST",29139,27772,29867,728
SOCO,"12/22/2024 1 p.m. CST",27832,26473,28644,812
SOCO,"12/22/2024 2 p.m. CST",26858,25516,27811,953
SOCO,"12/22/2024 3 p.m. CST",26081,25134,27414,1333
SOCO,"12/22/2024 4 p.m. CST",26089,25440,27749,1660
SOCO,"12/22/2024 5 p.m. CST",27596,26979,29064,1468
SOCO,"12/22/2024 6 p.m. CST",29347,29129,31215,1868
SOCO,"12/22/2024 7 p.m. CST",30212,29925,32037,1825
SOCO,"12/22/2024 8 p.m. CST",30731,30425,32388,1657
SOCO,"12/22/2024 9 p.m. CST",30945,30636,32645,1700
SOCO,"12/22/2024 10 p.m. CST",30609,30309,32039,1430
SOCO,"12/22/2024 11 p.m. CST",30125,29804,31539,1414
SOCO,"12/23/2024 12 a.m. CST",30051,29377,31236,1185
SOCO,"12/23/2024 1 a.m. CST",30073,29237,30852,779
SOCO,"12/23/2024 2 a.m. CST",30326,29348,31099,773
SOCO,"12/23/2024 3 a.m. CST",30319,29722,31015,696
SOCO,"12/23/2024 4 a.m. CST",31003,30404,31354,351
SOCO,"12/23/2024 5 a.m. CST",31899,31401,32032,133
SOCO,"12/23/2024 6 a.m. CST",33541,33009,33868,327
SOCO,"12/23/2024 7 a.m. CST",35153,34676,35462,309
SOCO,"12/23/2024 8 a.m. CST",35604,35045,35853,249
SOCO,"12/23/2024 9 a.m. CST",34535,34020,35474,939
SOCO,"12/23/2024 10 a.m. CST",32705,32300,33644,939
SOCO,"12/23/2024 11 a.m. CST",31157,30603,31883,726
SOCO,"12/23/2024 12 p.m. CST",30171,29053,30822,651
SOCO,"12/23/2024 1 p.m. CST",29127,27827,29772,645
SOCO,"12/23/2024 2 p.m. CST",28149,26860,28900,751
SOCO,"12/23/2024 3 p.m. CST",27649,26375,28472,823
SOCO,"12/23/2024 4 p.m. CST",27773,26506,28619,846
SOCO,"12/23/2024 5 p.m. CST",28269,27713,29132,863
SOCO,"12/23/2024 6 p.m. CST",29478,29269,30493,1015
SOCO,"12/23/2024 7 p.m. CST",30054,29831,31412,1358
SOCO,"12/23/2024 8 p.m. CST",30353,30141,31397,1044
SOCO,"12/23/2024 9 p.m. CST",30281,30055,31004,723
SOCO,"12/23/2024 10 p.m. CST",29806,29620,30265,459
SOCO,"12/23/2024 11 p.m. CST",29148,28850,29461,313
SOCO,"12/24/2024 12 a.m. CST",28509,28234,28737,228
SOCO,"12/24/2024 1 a.m. CST",28416,27788,28557,141
SOCO,"12/24/2024 2 a.m. CST",28693,27718,28778,85
SOCO,"12/24/2024 3 a.m. CST",28904,27889,28839,-65
SOCO,"12/24/2024 4 a.m. CST",29197,28371,29144,-53
SOCO,"12/24/2024 5 a.m. CST",29589,29313,29629,40
SOCO,"12/24/2024 6 a.m. CST",30767,30484,31382,615
SOCO,"12/24/2024 7 a.m. CST",32068,31813,32757,689
SOCO,"12/24/2024 8 a.m. CST",32686,32351,33358,672
SOCO,"12/24/2024 9 a.m. CST",31827,31486,32405,578
SOCO,"12/24/2024 10 a.m. CST",30063,29718,30571,508
SOCO,"12/24/2024 11 a.m. CST",28712,27810,29364,652
SOCO,"12/24/2024 12 p.m. CST",27155,26104,27847,692
SOCO,"12/24/2024 1 p.m. CST",25732,24683,26496,764
SOCO,"12/24/2024 2 p.m. CST",24793,23770,25772,979
SOCO,"12/24/2024 3 p.m. CST",24262,23243,25235,973
SOCO,"12/24/2024 4 p.m. CST",24170,23180,25514,1344
SOCO,"12/24/2024 5 p.m. CST",24424,23908,25666,1242
SOCO,"12/24/2024 6 p.m. CST",25293,25067,26471,1178
SOCO,"12/24/2024 7 p.m. CST",25576,25338,26778,1202
SOCO,"12/24/2024 8 p.m. CST",25854,25614,27032,1178
SOCO,"12/24/2024 9 p.m. CST",25994,25746,27184,1190
SOCO,"12/24/2024 10 p.m. CST",25964,25732,26761,797
SOCO,"12/24/2024 11 p.m. CST",25793,25548,26390,597
SOCO,"12/25/2024 12 a.m. CST",25596,25334,26142,546
SOCO,"12/25/2024 1 a.m. CST",25833,25275,26317,484
SOCO,"12/25/2024 2 a.m. CST",25999,25399,26441,442
SOCO,"12/25/2024 3 a.m. CST",26343,25732,26848,505
SOCO,"12/25/2024 4 a.m. CST",26540,26231,27163,623
SOCO,"12/25/2024 5 a.m. CST",27203,26984,27604,401
SOCO,"12/25/2024 6 a.m. CST",28221,27979,28649,428
SOCO,"12/25/2024 7 a.m. CST",29323,29078,30057,734
SOCO,"12/25/2024 8 a.m. CST",29961,29664,30618,657
SOCO,"12/25/2024 9 a.m. CST",29029,28722,29563,534
SOCO,"12/25/2024 10 a.m. CST",27211,26917,27663,452
SOCO,"12/25/2024 11 a.m. CST",25748,25287,26182,434
SOCO,"12/25/2024 12 p.m. CST",24638,23942,25204,566
SOCO,"12/25/2024 1 p.m. CST",23802,22755,24493,691
SOCO,"12/25/2024 2 p.m. CST",23369,21934,24061,692
SOCO,"12/25/2024 3 p.m. CST",22656,21451,23545,889
SOCO,"12/25/2024 4 p.m. CST",22585,21531,23513,928
SOCO,"12/25/2024 5 p.m. CST",22816,22373,23645,829
SOCO,"12/25/2024 6 p.m. CST",23716,23499,24705,989
SOCO,"12/25/2024 7 p.m. CST",24037,23828,25301,1264
SOCO,"12/25/2024 8 p.m. CST",24265,24046,25728,1463
SOCO,"12/25/2024 9 p.m. CST",24149,23950,25572,1423
SOCO,"12/25/2024 10 p.m. CST",23700,23498,24941,1241
SOCO,"12/25/2024 11 p.m. CST",23047,22851,24074,1027
SOCO,"12/26/2024 12 a.m. CST",22372,22175,23411,1039
SOCO,"12/26/2024 1 a.m. CST",22597,21719,23291,694
SOCO,"12/26/2024 2 a.m. CST",22434,21487,23398,964
SOCO,"12/26/2024 3 a.m. CST",22456,21545,23195,739
SOCO,"12/26/2024 4 a.m. CST",22660,21948,23539,879
SOCO,"12/26/2024 5 a.m. CST",23205,22819,23877,672
SOCO,"12/26/2024 6 a.m. CST",24181,24018,24989,808
SOCO,"12/26/2024 7 a.m. CST",25366,25266,26476,1110
SOCO,"12/26/2024 8 a.m. CST",26260,26074,27229,969
SOCO,"12/26/2024 9 a.m. CST",26978,26775,27820,842
SOCO,"12/26/2024 10 a.m. CST",27344,27112,28004,660
SOCO,"12/26/2024 11 a.m. CST",27338,27110,28022,684
SOCO,"12/26/2024 12 p.m. CST",27034,26783,27578,544
SOCO,"12/26/2024 1 p.m. CST",27364,26431,27761,397
SOCO,"12/26/2024 2 p.m. CST",27113,26138,27426,313
SOCO,"12/26/2024 3 p.m. CST",26844,26035,27389,545
SOCO,"12/26/2024 4 p.m. CST",26477,26256,27251,774
SOCO,"12/26/2024 5 p.m. CST",27332,26985,28097,765
SOCO,"12/26/2024 6 p.m. CST",28121,27824,29060,939
SOCO,"12/26/2024 7 p.m. CST",27967,27631,28800,833
SOCO,"12/26/2024 8 p.m. CST",27579,27230,28308,729
SOCO,"12/26/2024 9 p.m. CST",26868,26539,27643,775
SOCO,"12/26/2024 10 p.m. CST",25764,25581,26935,1171
SOCO,"12/26/2024 11 p.m. CST",24687,24500,25672,985
SOCO,"12/27/2024 12 a.m. CST",24123,23580,25092,969
SOCO,"12/27/2024 1 a.m. CST",23931,22907,24842,911
SOCO,"12/27/2024 2 a.m. CST",23544,22520,24482,938
SOCO,"12/27/2024 3 a.m. CST",23425,22393,24429,1004
SOCO,"12/27/2024 4 a.m. CST",23665,22662,24566,901
SOCO,"12/27/2024 5 a.m. CST",23953,23369,24769,816
SOCO,"12/27/2024 6 a.m. CST",24578,24436,25679,1101
SOCO,"12/27/2024 7 a.m. CST",25709,25614,27094,1385
SOCO,"12/27/2024 8 a.m. CST",26466,26311,27638,1172
SOCO,"12/27/2024 9 a.m. CST",27174,26979,28054,880
SOCO,"12/27/2024 10 a.m. CST",27542,27332,28213,671
SOCO,"12/27/2024 11 a.m. CST",27497,27278,28162,665
SOCO,"12/27/2024 12 p.m. CST",27600,26999,28086,486
SOCO,"12/27/2024 1 p.m. CST",27520,26554,28013,493
SOCO,"12/27/2024 2 p.m. CST",27207,26241,27803,596
SOCO,"12/27/2024 3 p.m. CST",26914,25993,27612,698
SOCO,"12/27/2024 4 p.m. CST",26250,25980,26880,630
SOCO,"12/27/2024 5 p.m. CST",26832,26695,27703,871
SOCO,"12/27/2024 6 p.m. CST",27340,27089,28075,735
SOCO,"12/27/2024 7 p.m. CST",27060,26695,27963,903
SOCO,"12/27/2024 8 p.m. CST",26299,25953,27351,1052
SOCO,"12/27/2024 9 p.m. CST",25505,25176,26465,960
SOCO,"12/27/2024 10 p.m. CST",24552,24204,25619,1067
SOCO,"12/27/2024 11 p.m. CST",23400,23228,24520,1120
SOCO,"12/28/2024 12 a.m. CST",22725,22229,23821,1096
SOCO,"12/28/2024 1 a.m. CST",21972,21391,22841,869
SOCO,"12/28/2024 2 a.m. CST",21749,20777,22490,741
SOCO,"12/28/2024 3 a.m. CST",21455,20491,22258,803
SOCO,"12/28/2024 4 a.m. CST",21391,20426,22364,973
SOCO,"12/28/2024 5 a.m. CST",20983,20688,21971,988
SOCO,"12/28/2024 6 a.m. CST",21335,21170,22609,1274
SOCO,"12/28/2024 7 a.m. CST",21983,21803,23136,1153
SOCO,"12/28/2024 8 a.m. CST",22664,22483,23823,1159
SOCO,"12/28/2024 9 a.m. CST",23524,23322,24512,988
SOCO,"12/28/2024 10 a.m. CST",24033,23822,24661,628
SOCO,"12/28/2024 11 a.m. CST",24236,24018,24815,579
SOCO,"12/28/2024 12 p.m. CST",24507,23934,25015,508
SOCO,"12/28/2024 1 p.m. CST",24307,23718,24840,533
SOCO,"12/28/2024 2 p.m. CST",24048,23467,24767,719
SOCO,"12/28/2024 3 p.m. CST",23846,23377,24673,827
SOCO,"12/28/2024 4 p.m. CST",23749,23525,24718,969
SOCO,"12/28/2024 5 p.m. CST",24421,24069,25211,790
SOCO,"12/28/2024 6 p.m. CST",25019,24648,25701,682
SOCO,"12/28/2024 7 p.m. CST",24705,24349,25259,554
SOCO,"12/28/2024 8 p.m. CST",24075,23728,24775,700
SOCO,"12/28/2024 9 p.m. CST",23333,23130,24138,805
SOCO,"12/28/2024 10 p.m. CST",22434,22247,23228,794
SOCO,"12/28/2024 11 p.m. CST",21333,21151,22195,862
SOCO,"12/29/2024 12 a.m. CST",20663,20101,21375,712
SOCO,"12/29/2024 1 a.m. CST",20113,19168,20654,541
SOCO,"12/29/2024 2 a.m. CST",19542,18568,20412,870
SOCO,"12/29/2024 3 a.m. CST",19287,18305,20123,836
SOCO,"12/29/2024 4 a.m. CST",19069,18072,19902,833
SOCO,"12/29/2024 5 a.m. CST",19139,18154,20068,929
SOCO,"12/29/2024 6 a.m. CST",18900,18636,20094,1194
SOCO,"12/29/2024 7 a.m. CST",19484,19277,20567,1083
SOCO,"12/29/2024 8 a.m. CST",20270,20046,21124,854
SOCO,"12/29/2024 9 a.m. CST",21263,21072,22077,814
SOCO,"12/29/2024 10 a.m. CST",21886,21674,22681,795
SOCO,"12/29/2024 11 a.m. CST",22125,21897,22937,812
SOCO,"12/29/2024 12 p.m. CST",22248,21980,23248,1000
SOCO,"12/29/2024 1 p.m. CST",22428,21821,23624,1196
SOCO,"12/29/2024 2 p.m. CST",22205,21587,23521,1316
SOCO,"12/29/2024 3 p.m. CST",22092,21474,23566,1474
SOCO,"12/29/2024 4 p.m. CST",21912,21670,23249,1337
SOCO,"12/29/2024 5 p.m. CST",22538,22397,23798,1260
SOCO,"12/29/2024 6 p.m. CST",23823,23595,24860,1037
SOCO,"12/29/2024 7 p.m. CST",23950,23718,25032,1082
SOCO,"12/29/2024 8 p.m. CST",23840,23628,24722,882
SOCO,"12/29/2024 9 p.m. CST",23445,23216,24377,932
SOCO,"12/29/2024 10 p.m. CST",22795,22589,23550,755
SOCO,"12/29/2024 11 p.m. CST",22032,21828,22943,911
SOCO,"12/30/2024 12 a.m. CST",21394,21191,22314,920
SOCO,"12/30/2024 1 a.m. CST",21558,20715,22079,521
SOCO,"12/30/2024 2 a.m. CST",21462,20498,21839,377
SOCO,"12/30/2024 3 a.m. CST",21530,20595,21839,309
SOCO,"12/30/2024 4 a.m. CST",22100,21152,22435,335
SOCO,"12/30/2024 5 a.m. CST",22756,22175,22984,228
SOCO,"12/30/2024 6 a.m. CST",23763,23570,24113,350
SOCO,"12/30/2024 7 a.m. CST",25249,25021,25981,732
SOCO,"12/30/2024 8 a.m. CST",25930,25689,26473,543
SOCO,"12/30/2024 9 a.m. CST",25683,25427,26420,737
SOCO,"12/30/2024 10 a.m. CST",25156,24909,25790,634
SOCO,"12/30/2024 11 a.m. CST",24902,24346,25481,579
SOCO,"12/30/2024 12 p.m. CST",24322,23668,25057,735
SOCO,"12/30/2024 1 p.m. CST",23815,23162,24600,785
SOCO,"12/30/2024 2 p.m. CST",23512,22849,24431,919
SOCO,"12/30/2024 3 p.m. CST",23315,22654,24695,1380
SOCO,"12/30/2024 4 p.m. CST",22937,22613,24378,1441
SOCO,"12/30/2024 5 p.m. CST",23435,23305,24642,1207
SOCO,"12/30/2024 6 p.m. CST",24655,24497,25699,1044
SOCO,"12/30/2024 7 p.m. CST",24783,24565,25876,1093
SOCO,"12/30/2024 8 p.m. CST",24653,24432,25613,960
SOCO,"12/30/2024 9 p.m. CST",24245,24042,25455,1210
SOCO,"12/30/2024 10 p.m. CST",23541,23337,24866,1325
SOCO,"12/30/2024 11 p.m. CST",22622,22402,23644,1022
SOCO,"12/31/2024 12 a.m. CST",21741,21912,22696,955
SOCO,"12/31/2024 1 a.m. CST",21776,20897,22403,627
SOCO,"12/31/2024 2 a.m. CST",21433,20508,22103,670
SOCO,"12/31/2024 3 a.m. CST",21286,20339,21800,514
SOCO,"12/31/2024 4 a.m. CST",21311,20392,21915,604
SOCO,"12/31/2024 5 a.m. CST",21521,20943,22234,713
SOCO,"12/31/2024 6 a.m. CST",22080,21882,23125,1045
SOCO,"12/31/2024 7 a.m. CST",22954,22769,23970,1016
SOCO,"12/31/2024 8 a.m. CST",23411,23215,24412,1001
SOCO,"12/31/2024 9 a.m. CST",23733,23499,24631,898
SOCO,"12/31/2024 10 a.m. CST",23681,23438,24451,770
SOCO,"12/31/2024 11 a.m. CST",23670,23298,24374,704
SOCO,"12/31/2024 12 p.m. CST",23642,22950,24501,859
SOCO,"12/31/2024 1 p.m. CST",23493,22743,24526,1033
SOCO,"12/31/2024 2 p.m. CST",23282,22536,24462,1180
SOCO,"12/31/2024 3 p.m. CST",23096,22341,24565,1469
SOCO,"12/31/2024 4 p.m. CST",23072,22461,24694,1622
SOCO,"12/31/2024 5 p.m. CST",23255,22981,24770,1515
SOCO,"12/31/2024 6 p.m. CST",24147,23892,25760,1613
SOCO,"12/31/2024 7 p.m. CST",23861,23630,25389,1528
SOCO,"12/31/2024 8 p.m. CST",23384,23127,24813,1429
SOCO,"12/31/2024 9 p.m. CST",22816,22584,24109,1293
SOCO,"12/31/2024 10 p.m. CST",22187,21929,23486,1299
SOCO,"12/31/2024 11 p.m. CST",21616,21392,22489,873
SOCO,"1/1/2025 12 a.m. CST",21136,20886,21958,822
