"BA Code","Timestamp (Hour Ending)","Demand (MWh)","Demand Forecast (MWh)","Net Generation (MWh)","Total Interchange (MWh)"
SOCO,"8/1/2024 12 a.m. CDT",30390,29850,31163,773
SOCO,"8/1/2024 1 a.m. CDT",29303,28054,30238,935
SOCO,"8/1/2024 2 a.m. CDT",28561,26813,29529,968
SOCO,"8/1/2024 3 a.m. CDT",27714,25971,28877,1163
SOCO,"8/1/2024 4 a.m. CDT",27395,25689,28852,1457
SOCO,"8/1/2024 5 a.m. CDT",27126,25918,28495,1369
SOCO,"8/1/2024 6 a.m. CDT",28070,26909,29506,1436
SOCO,"8/1/2024 7 a.m. CDT",28025,27584,30180,2155
SOCO,"8/1/2024 8 a.m. CDT",29336,29076,31810,2474
SOCO,"8/1/2024 9 a.m. CDT",31795,31520,34571,2776
SOCO,"8/1/2024 10 a.m. CDT",34905,34700,37506,2601
SOCO,"8/1/2024 11 a.m. CDT",38076,37879,40706,2630
SOCO,"8/1/2024 12 p.m. CDT",40708,40580,43407,2699
SOCO,"8/1/2024 1 p.m. CDT",42640,42593,45975,3335
SOCO,"8/1/2024 2 p.m. CDT",43759,43716,46982,3223
SOCO,"8/1/2024 3 p.m. CDT",44232,44060,47766,3534
SOCO,"8/1/2024 4 p.m. CDT",44321,44208,47927,3606
SOCO,"8/1/2024 5 p.m. CDT",44083,43945,47630,3547
SOCO,"8/1/2024 6 p.m. CDT",43338,43223,46883,3545
SOCO,"8/1/2024 7 p.m. CDT",42293,42125,45835,3542
SOCO,"8/1/2024 8 p.m. CDT",40697,40644,44214,3517
SOCO,"8/1/2024 9 p.m. CDT",39433,39456,42243,2810
SOCO,"8/1/2024 10 p.m. CDT",37126,36901,38943,1817
SOCO,"8/1/2024 11 p.m. CDT",34691,34174,36024,1333
SOCO,"8/2/2024 12 a.m. CDT",32404,31406,33388,984
SOCO,"8/2/2024 1 a.m. CDT",31438,30163,32605,1167
SOCO,"8/2/2024 2 a.m. CDT",30513,28715,31270,757
SOCO,"8/2/2024 3 a.m. CDT",29435,27636,30215,780
SOCO,"8/2/2024 4 a.m. CDT",28889,27106,29790,901
SOCO,"8/2/2024 5 a.m. CDT",28894,27341,29680,786
SOCO,"8/2/2024 6 a.m. CDT",29310,28108,30195,885
SOCO,"8/2/2024 7 a.m. CDT",29233,28655,31089,1856
SOCO,"8/2/2024 8 a.m. CDT",30533,30073,32711,2178
SOCO,"8/2/2024 9 a.m. CDT",32708,32407,34937,2229
SOCO,"8/2/2024 10 a.m. CDT",35620,35429,37869,2249
SOCO,"8/2/2024 11 a.m. CDT",38557,38296,40916,2359
SOCO,"8/2/2024 12 p.m. CDT",40473,40401,43017,2544
SOCO,"8/2/2024 1 p.m. CDT",41908,41839,44434,2526
SOCO,"8/2/2024 2 p.m. CDT",42706,42594,45323,2617
SOCO,"8/2/2024 3 p.m. CDT",42715,42629,45471,2756
SOCO,"8/2/2024 4 p.m. CDT",42610,42517,45279,2669
SOCO,"8/2/2024 5 p.m. CDT",42035,41964,44699,2664
SOCO,"8/2/2024 6 p.m. CDT",40498,40441,43263,2765
SOCO,"8/2/2024 7 p.m. CDT",38686,38741,41811,3125
SOCO,"8/2/2024 8 p.m. CDT",37120,37144,39657,2537
SOCO,"8/2/2024 9 p.m. CDT",35904,35890,38591,2687
SOCO,"8/2/2024 10 p.m. CDT",33839,33729,36107,2268
SOCO,"8/2/2024 11 p.m. CDT",31771,31546,33164,1393
SOCO,"8/3/2024 12 a.m. CDT",29807,29476,30962,1155
SOCO,"8/3/2024 1 a.m. CDT",28489,27809,29463,974
SOCO,"8/3/2024 2 a.m. CDT",27528,26479,28520,992
SOCO,"8/3/2024 3 a.m. CDT",26552,25519,27966,1414
SOCO,"8/3/2024 4 a.m. CDT",25896,24877,27411,1515
SOCO,"8/3/2024 5 a.m. CDT",25698,24568,27042,1344
SOCO,"8/3/2024 6 a.m. CDT",26017,24619,27200,1183
SOCO,"8/3/2024 7 a.m. CDT",25439,24738,27266,1827
SOCO,"8/3/2024 8 a.m. CDT",26641,26247,28746,2105
SOCO,"8/3/2024 9 a.m. CDT",28781,28518,30923,2142
SOCO,"8/3/2024 10 a.m. CDT",31455,31278,33663,2208
SOCO,"8/3/2024 11 a.m. CDT",34268,34094,36291,2023
SOCO,"8/3/2024 12 p.m. CDT",36690,36645,38899,2209
SOCO,"8/3/2024 1 p.m. CDT",38433,38382,40505,2072
SOCO,"8/3/2024 2 p.m. CDT",39656,39474,41590,1934
SOCO,"8/3/2024 3 p.m. CDT",39882,39735,41972,2090
SOCO,"8/3/2024 4 p.m. CDT",40085,39942,41883,1798
SOCO,"8/3/2024 5 p.m. CDT",39885,39859,41527,1642
SOCO,"8/3/2024 6 p.m. CDT",39133,39109,40869,1736
SOCO,"8/3/2024 7 p.m. CDT",37774,37725,39607,1833
SOCO,"8/3/2024 8 p.m. CDT",35954,35906,37935,1981
SOCO,"8/3/2024 9 p.m. CDT",34555,34523,36640,2085
SOCO,"8/3/2024 10 p.m. CDT",32375,32495,34528,2153
SOCO,"8/3/2024 11 p.m. CDT",30229,30159,31977,1748
SOCO,"8/4/2024 12 a.m. CDT",28176,27987,29972,1796
SOCO,"8/4/2024 1 a.m. CDT",26957,26338,28579,1622
SOCO,"8/4/2024 2 a.m. CDT",25955,24987,27697,1742
SOCO,"8/4/2024 3 a.m. CDT",25413,24113,27154,1741
SOCO,"8/4/2024 4 a.m. CDT",24765,23425,26452,1687
SOCO,"8/4/2024 5 a.m. CDT",24414,23105,26153,1739
SOCO,"8/4/2024 6 a.m. CDT",24449,23133,26198,1749
SOCO,"8/4/2024 7 a.m. CDT",24199,23264,26532,2333
SOCO,"8/4/2024 8 a.m. CDT",25326,24987,27759,2433
SOCO,"8/4/2024 9 a.m. CDT",27734,27517,30190,2456
SOCO,"8/4/2024 10 a.m. CDT",30667,30550,32738,2071
SOCO,"8/4/2024 11 a.m. CDT",33523,33419,35490,1967
SOCO,"8/4/2024 12 p.m. CDT",36070,36095,37917,1847
SOCO,"8/4/2024 1 p.m. CDT",38101,38081,39758,1657
SOCO,"8/4/2024 2 p.m. CDT",39446,39314,41316,1870
SOCO,"8/4/2024 3 p.m. CDT",40156,40026,42398,2242
SOCO,"8/4/2024 4 p.m. CDT",40499,40389,42772,2273
SOCO,"8/4/2024 5 p.m. CDT",40419,40391,42778,2359
SOCO,"8/4/2024 6 p.m. CDT",39587,39596,42055,2468
SOCO,"8/4/2024 7 p.m. CDT",38261,38204,40462,2201
SOCO,"8/4/2024 8 p.m. CDT",36878,36865,38875,1997
SOCO,"8/4/2024 9 p.m. CDT",35668,35617,37618,1950
SOCO,"8/4/2024 10 p.m. CDT",33263,33374,35471,2208
SOCO,"8/4/2024 11 p.m. CDT",30882,30842,32536,1654
SOCO,"8/5/2024 12 a.m. CDT",28750,28582,30337,1587
SOCO,"8/5/2024 1 a.m. CDT",27972,27028,29331,1359
SOCO,"8/5/2024 2 a.m. CDT",27058,25884,28555,1497
SOCO,"8/5/2024 3 a.m. CDT",26657,25206,28273,1616
SOCO,"8/5/2024 4 a.m. CDT",26389,24946,28063,1674
SOCO,"8/5/2024 5 a.m. CDT",26946,25524,28532,1586
SOCO,"8/5/2024 6 a.m. CDT",27947,26708,29297,1350
SOCO,"8/5/2024 7 a.m. CDT",28290,27477,29771,1481
SOCO,"8/5/2024 8 a.m. CDT",28948,28701,30325,1377
SOCO,"8/5/2024 9 a.m. CDT",30586,30373,32325,1739
SOCO,"8/5/2024 10 a.m. CDT",32680,32583,34249,1569
SOCO,"8/5/2024 11 a.m. CDT",34788,34666,36478,1690
SOCO,"8/5/2024 12 p.m. CDT",36653,36656,38360,1707
SOCO,"8/5/2024 1 p.m. CDT",38283,38282,40752,2469
SOCO,"8/5/2024 2 p.m. CDT",39329,39312,42000,2671
SOCO,"8/5/2024 3 p.m. CDT",40118,40109,43090,2972
SOCO,"8/5/2024 4 p.m. CDT",40556,40621,43425,2869
SOCO,"8/5/2024 5 p.m. CDT",40598,40690,43601,3003
SOCO,"8/5/2024 6 p.m. CDT",40039,40079,42941,2902
SOCO,"8/5/2024 7 p.m. CDT",39042,39226,42049,3007
SOCO,"8/5/2024 8 p.m. CDT",37620,37703,40536,2916
SOCO,"8/5/2024 9 p.m. CDT",36275,36302,38331,2056
SOCO,"8/5/2024 10 p.m. CDT",33908,33924,35888,1980
SOCO,"8/5/2024 11 p.m. CDT",31800,31569,33229,1429
SOCO,"8/6/2024 12 a.m. CDT",29928,29159,31278,1350
SOCO,"8/6/2024 1 a.m. CDT",28718,27479,29856,1138
SOCO,"8/6/2024 2 a.m. CDT",27517,26312,28770,1253
SOCO,"8/6/2024 3 a.m. CDT",26675,25461,27701,1026
SOCO,"8/6/2024 4 a.m. CDT",26370,25069,27414,1044
SOCO,"8/6/2024 5 a.m. CDT",27030,25446,27874,844
SOCO,"8/6/2024 6 a.m. CDT",27820,26618,28798,978
SOCO,"8/6/2024 7 a.m. CDT",28235,27392,29613,1378
SOCO,"8/6/2024 8 a.m. CDT",28846,28373,30195,1349
SOCO,"8/6/2024 9 a.m. CDT",30597,30067,31972,1375
SOCO,"8/6/2024 10 a.m. CDT",32515,32202,34192,1677
SOCO,"8/6/2024 11 a.m. CDT",34811,34494,36537,1726
SOCO,"8/6/2024 12 p.m. CDT",36974,36646,39010,2036
SOCO,"8/6/2024 1 p.m. CDT",38784,38426,41068,2284
SOCO,"8/6/2024 2 p.m. CDT",40078,39725,42752,2674
SOCO,"8/6/2024 3 p.m. CDT",40814,40400,43285,2471
SOCO,"8/6/2024 4 p.m. CDT",41418,40992,43799,2381
SOCO,"8/6/2024 5 p.m. CDT",41394,40973,44013,2619
SOCO,"8/6/2024 6 p.m. CDT",40811,40396,43396,2585
SOCO,"8/6/2024 7 p.m. CDT",39808,39410,42476,2668
SOCO,"8/6/2024 8 p.m. CDT",38434,38137,40335,1901
SOCO,"8/6/2024 9 p.m. CDT",37178,36912,38838,1660
SOCO,"8/6/2024 10 p.m. CDT",34948,34457,35902,954
SOCO,"8/6/2024 11 p.m. CDT",32358,31848,33374,1016
SOCO,"8/7/2024 12 a.m. CDT",30498,29657,31538,1040
SOCO,"8/7/2024 1 a.m. CDT",28683,27823,29401,718
SOCO,"8/7/2024 2 a.m. CDT",27763,26557,28601,838
SOCO,"8/7/2024 3 a.m. CDT",26878,25681,27904,1026
SOCO,"8/7/2024 4 a.m. CDT",26479,25276,27610,1131
SOCO,"8/7/2024 5 a.m. CDT",26777,25605,27858,1081
SOCO,"8/7/2024 6 a.m. CDT",27881,26712,28955,1074
SOCO,"8/7/2024 7 a.m. CDT",28557,27398,29877,1320
SOCO,"8/7/2024 8 a.m. CDT",29317,28640,30993,1676
SOCO,"8/7/2024 9 a.m. CDT",31141,30727,32732,1591
SOCO,"8/7/2024 10 a.m. CDT",33862,33454,35195,1333
SOCO,"8/7/2024 11 a.m. CDT",36807,36355,38069,1262
SOCO,"8/7/2024 12 p.m. CDT",39319,39022,40543,1224
SOCO,"8/7/2024 1 p.m. CDT",41294,40958,42857,1563
SOCO,"8/7/2024 2 p.m. CDT",42736,42351,44183,1447
SOCO,"8/7/2024 3 p.m. CDT",43792,43382,44971,1179
SOCO,"8/7/2024 4 p.m. CDT",44421,44014,45878,1457
SOCO,"8/7/2024 5 p.m. CDT",44406,44003,46084,1678
SOCO,"8/7/2024 6 p.m. CDT",43775,43396,45294,1519
SOCO,"8/7/2024 7 p.m. CDT",42576,42210,43899,1323
SOCO,"8/7/2024 8 p.m. CDT",40929,40563,41657,728
SOCO,"8/7/2024 9 p.m. CDT",39371,39119,40298,927
SOCO,"8/7/2024 10 p.m. CDT",36905,36374,37813,908
SOCO,"8/7/2024 11 p.m. CDT",34115,33623,34988,873
SOCO,"8/8/2024 12 a.m. CDT",31850,31313,32428,578
SOCO,"8/8/2024 1 a.m. CDT",30516,29327,30512,-4
SOCO,"8/8/2024 2 a.m. CDT",29599,27977,30035,436
SOCO,"8/8/2024 3 a.m. CDT",28724,26954,29225,501
SOCO,"8/8/2024 4 a.m. CDT",28196,26455,28792,596
SOCO,"8/8/2024 5 a.m. CDT",28475,26727,29194,719
SOCO,"8/8/2024 6 a.m. CDT",29250,27759,29741,491
SOCO,"8/8/2024 7 a.m. CDT",29300,28473,30230,930
SOCO,"8/8/2024 8 a.m. CDT",30611,29731,31657,1046
SOCO,"8/8/2024 9 a.m. CDT",32381,31854,33295,914
SOCO,"8/8/2024 10 a.m. CDT",35103,34536,35934,831
SOCO,"8/8/2024 11 a.m. CDT",37666,37520,38681,1015
SOCO,"8/8/2024 12 p.m. CDT",40072,40041,40998,926
SOCO,"8/8/2024 1 p.m. CDT",42085,42021,43000,915
SOCO,"8/8/2024 2 p.m. CDT",43334,43138,44238,904
SOCO,"8/8/2024 3 p.m. CDT",44046,43803,45362,1316
SOCO,"8/8/2024 4 p.m. CDT",44593,44397,45906,1313
SOCO,"8/8/2024 5 p.m. CDT",44381,44233,45737,1356
SOCO,"8/8/2024 6 p.m. CDT",43496,43377,44465,969
SOCO,"8/8/2024 7 p.m. CDT",41985,41921,42684,699
SOCO,"8/8/2024 8 p.m. CDT",40478,40417,40618,140
SOCO,"8/8/2024 9 p.m. CDT",39221,39031,39138,-83
SOCO,"8/8/2024 10 p.m. CDT",36677,36473,37014,337
SOCO,"8/8/2024 11 p.m. CDT",34061,33862,34664,603
SOCO,"8/9/2024 12 a.m. CDT",31670,31247,32393,723
SOCO,"8/9/2024 1 a.m. CDT",30324,29266,30825,501
SOCO,"8/9/2024 2 a.m. CDT",29474,27953,30058,584
SOCO,"8/9/2024 3 a.m. CDT",28617,26952,29297,680
SOCO,"8/9/2024 4 a.m. CDT",28102,26431,28844,742
SOCO,"8/9/2024 5 a.m. CDT",28356,26696,29045,689
SOCO,"8/9/2024 6 a.m. CDT",29337,27677,30008,671
SOCO,"8/9/2024 7 a.m. CDT",29387,28381,30521,1134
SOCO,"8/9/2024 8 a.m. CDT",30120,29615,31403,1283
SOCO,"8/9/2024 9 a.m. CDT",32397,31871,33631,1234
SOCO,"8/9/2024 10 a.m. CDT",35188,34633,36270,1082
SOCO,"8/9/2024 11 a.m. CDT",37786,37660,39296,1510
SOCO,"8/9/2024 12 p.m. CDT",40235,40196,41469,1234
SOCO,"8/9/2024 1 p.m. CDT",42107,42066,43260,1153
SOCO,"8/9/2024 2 p.m. CDT",43248,43173,44390,1142
SOCO,"8/9/2024 3 p.m. CDT",43837,43881,45086,1249
SOCO,"8/9/2024 4 p.m. CDT",44208,44240,45468,1260
SOCO,"8/9/2024 5 p.m. CDT",44072,44033,45560,1488
SOCO,"8/9/2024 6 p.m. CDT",42964,42951,44467,1503
SOCO,"8/9/2024 7 p.m. CDT",41404,41447,42867,1463
SOCO,"8/9/2024 8 p.m. CDT",39645,39701,41374,1729
SOCO,"8/9/2024 9 p.m. CDT",38037,38103,39691,1654
SOCO,"8/9/2024 10 p.m. CDT",35702,35664,37102,1400
SOCO,"8/9/2024 11 p.m. CDT",33244,33052,34373,1129
SOCO,"8/10/2024 12 a.m. CDT",30903,30532,31643,740
SOCO,"8/10/2024 1 a.m. CDT",28689,28396,29602,913
SOCO,"8/10/2024 2 a.m. CDT",27625,26849,28633,1008
SOCO,"8/10/2024 3 a.m. CDT",26868,25667,27824,956
SOCO,"8/10/2024 4 a.m. CDT",26571,24882,27300,729
SOCO,"8/10/2024 5 a.m. CDT",26243,24551,26937,694
SOCO,"8/10/2024 6 a.m. CDT",26162,24494,27063,901
SOCO,"8/10/2024 7 a.m. CDT",26162,24557,27116,954
SOCO,"8/10/2024 8 a.m. CDT",27080,26101,28170,1090
SOCO,"8/10/2024 9 a.m. CDT",28932,28568,30285,1353
SOCO,"8/10/2024 10 a.m. CDT",32004,31792,33451,1447
SOCO,"8/10/2024 11 a.m. CDT",35030,34872,36566,1536
SOCO,"8/10/2024 12 p.m. CDT",37735,37571,39615,1880
SOCO,"8/10/2024 1 p.m. CDT",39678,39516,41372,1694
SOCO,"8/10/2024 2 p.m. CDT",40990,40810,42601,1611
SOCO,"8/10/2024 3 p.m. CDT",41644,41586,43065,1421
SOCO,"8/10/2024 4 p.m. CDT",42289,42268,43707,1418
SOCO,"8/10/2024 5 p.m. CDT",42189,42146,43556,1367
SOCO,"8/10/2024 6 p.m. CDT",41398,41395,42890,1492
SOCO,"8/10/2024 7 p.m. CDT",39833,39849,41169,1336
SOCO,"8/10/2024 8 p.m. CDT",37897,37918,39496,1599
SOCO,"8/10/2024 9 p.m. CDT",36173,36103,37676,1503
SOCO,"8/10/2024 10 p.m. CDT",33706,33639,35004,1298
SOCO,"8/10/2024 11 p.m. CDT",31283,31193,32306,1023
SOCO,"8/11/2024 12 a.m. CDT",28930,28727,29845,915
SOCO,"8/11/2024 1 a.m. CDT",27066,26757,27560,494
SOCO,"8/11/2024 2 a.m. CDT",26115,25226,26598,483
SOCO,"8/11/2024 3 a.m. CDT",25140,24063,25810,670
SOCO,"8/11/2024 4 a.m. CDT",24840,23274,25616,776
SOCO,"8/11/2024 5 a.m. CDT",24353,22790,25135,782
SOCO,"8/11/2024 6 a.m. CDT",23986,22620,24834,848
SOCO,"8/11/2024 7 a.m. CDT",23748,22659,24794,1046
SOCO,"8/11/2024 8 a.m. CDT",25136,24095,26207,1071
SOCO,"8/11/2024 9 a.m. CDT",27065,26410,28675,1610
SOCO,"8/11/2024 10 a.m. CDT",29614,29416,31541,1927
SOCO,"8/11/2024 11 a.m. CDT",32461,32340,34315,1854
SOCO,"8/11/2024 12 p.m. CDT",35419,35299,37214,1795
SOCO,"8/11/2024 1 p.m. CDT",37837,37664,39665,1828
SOCO,"8/11/2024 2 p.m. CDT",39557,39417,41175,1618
SOCO,"8/11/2024 3 p.m. CDT",40634,40440,41911,1277
SOCO,"8/11/2024 4 p.m. CDT",41353,41152,42512,1159
SOCO,"8/11/2024 5 p.m. CDT",41562,41398,42826,1264
SOCO,"8/11/2024 6 p.m. CDT",40927,40802,42366,1439
SOCO,"8/11/2024 7 p.m. CDT",39349,39298,40562,1213
SOCO,"8/11/2024 8 p.m. CDT",37507,37429,38691,1184
SOCO,"8/11/2024 9 p.m. CDT",35705,35557,37071,1366
SOCO,"8/11/2024 10 p.m. CDT",32949,32664,34137,1188
SOCO,"8/11/2024 11 p.m. CDT",30151,29850,31130,979
SOCO,"8/12/2024 12 a.m. CDT",27723,27358,28644,921
SOCO,"8/12/2024 1 a.m. CDT",26232,25534,26831,599
SOCO,"8/12/2024 2 a.m. CDT",25235,24175,25818,583
SOCO,"8/12/2024 3 a.m. CDT",24434,23381,24847,413
SOCO,"8/12/2024 4 a.m. CDT",24046,23137,24591,545
SOCO,"8/12/2024 5 a.m. CDT",24634,23717,25513,879
SOCO,"8/12/2024 6 a.m. CDT",25818,24921,26698,880
SOCO,"8/12/2024 7 a.m. CDT",26304,25734,27134,830
SOCO,"8/12/2024 8 a.m. CDT",27475,26879,28980,1505
SOCO,"8/12/2024 9 a.m. CDT",29014,28741,31161,2147
SOCO,"8/12/2024 10 a.m. CDT",31628,31296,33636,2008
SOCO,"8/12/2024 11 a.m. CDT",34525,34173,36408,1883
SOCO,"8/12/2024 12 p.m. CDT",37183,36838,38942,1759
SOCO,"8/12/2024 1 p.m. CDT",39392,39001,41332,1940
SOCO,"8/12/2024 2 p.m. CDT",41003,40670,42923,1920
SOCO,"8/12/2024 3 p.m. CDT",42025,41688,44132,2107
SOCO,"8/12/2024 4 p.m. CDT",42925,42636,44756,1831
SOCO,"8/12/2024 5 p.m. CDT",43021,42872,44937,1916
SOCO,"8/12/2024 6 p.m. CDT",42104,41986,43824,1720
SOCO,"8/12/2024 7 p.m. CDT",40673,40592,42671,1998
SOCO,"8/12/2024 8 p.m. CDT",39050,39055,40768,1718
SOCO,"8/12/2024 9 p.m. CDT",37166,37067,38871,1705
SOCO,"8/12/2024 10 p.m. CDT",34593,34164,36209,1616
SOCO,"8/12/2024 11 p.m. CDT",31681,31316,33012,1331
SOCO,"8/13/2024 12 a.m. CDT",29197,28831,29532,335
SOCO,"8/13/2024 1 a.m. CDT",27701,26931,27947,246
SOCO,"8/13/2024 2 a.m. CDT",26740,25608,26930,190
SOCO,"8/13/2024 3 a.m. CDT",25895,24750,26364,469
SOCO,"8/13/2024 4 a.m. CDT",25678,24403,26229,551
SOCO,"8/13/2024 5 a.m. CDT",26315,24739,26798,483
SOCO,"8/13/2024 6 a.m. CDT",27067,25804,27574,507
SOCO,"8/13/2024 7 a.m. CDT",27835,26625,28654,819
SOCO,"8/13/2024 8 a.m. CDT",28630,27755,29961,1331
SOCO,"8/13/2024 9 a.m. CDT",30439,29792,31957,1518
SOCO,"8/13/2024 10 a.m. CDT",32996,32404,34439,1443
SOCO,"8/13/2024 11 a.m. CDT",35587,35244,37167,1580
SOCO,"8/13/2024 12 p.m. CDT",38119,37764,39500,1381
SOCO,"8/13/2024 1 p.m. CDT",40068,39677,41624,1556
SOCO,"8/13/2024 2 p.m. CDT",41630,41229,43650,2020
SOCO,"8/13/2024 3 p.m. CDT",42610,42225,44745,2135
SOCO,"8/13/2024 4 p.m. CDT",43203,42884,45336,2133
SOCO,"8/13/2024 5 p.m. CDT",43122,42860,45552,2430
SOCO,"8/13/2024 6 p.m. CDT",42243,42057,44644,2401
SOCO,"8/13/2024 7 p.m. CDT",40878,40713,43040,2162
SOCO,"8/13/2024 8 p.m. CDT",39261,39081,41125,1864
SOCO,"8/13/2024 9 p.m. CDT",37521,37343,39068,1547
SOCO,"8/13/2024 10 p.m. CDT",35021,34588,36404,1383
SOCO,"8/13/2024 11 p.m. CDT",32204,31734,33141,937
SOCO,"8/14/2024 12 a.m. CDT",29895,29245,30866,971
SOCO,"8/14/2024 1 a.m. CDT",28817,27480,29498,681
SOCO,"8/14/2024 2 a.m. CDT",27580,26214,28268,688
SOCO,"8/14/2024 3 a.m. CDT",26897,25473,27673,776
SOCO,"8/14/2024 4 a.m. CDT",26659,25257,27500,841
SOCO,"8/14/2024 5 a.m. CDT",27230,25833,27956,726
SOCO,"8/14/2024 6 a.m. CDT",28472,27087,29115,643
SOCO,"8/14/2024 7 a.m. CDT",28723,27877,29527,804
SOCO,"8/14/2024 8 a.m. CDT",29504,28630,30414,910
SOCO,"8/14/2024 9 a.m. CDT",30652,30031,32011,1359
SOCO,"8/14/2024 10 a.m. CDT",32671,32107,33914,1243
SOCO,"8/14/2024 11 a.m. CDT",34587,34314,36157,1570
SOCO,"8/14/2024 12 p.m. CDT",36878,36525,38731,1853
SOCO,"8/14/2024 1 p.m. CDT",38932,38550,40981,2049
SOCO,"8/14/2024 2 p.m. CDT",40323,39919,42453,2130
SOCO,"8/14/2024 3 p.m. CDT",41041,40716,43114,2073
SOCO,"8/14/2024 4 p.m. CDT",41381,41086,43704,2323
SOCO,"8/14/2024 5 p.m. CDT",41224,40930,43445,2221
SOCO,"8/14/2024 6 p.m. CDT",40330,40090,42516,2186
SOCO,"8/14/2024 7 p.m. CDT",38980,38808,41474,2494
SOCO,"8/14/2024 8 p.m. CDT",37691,37423,40278,2587
SOCO,"8/14/2024 9 p.m. CDT",36071,35794,38484,2413
SOCO,"8/14/2024 10 p.m. CDT",33799,33300,35612,1813
SOCO,"8/14/2024 11 p.m. CDT",31223,30686,32539,1316
SOCO,"8/15/2024 12 a.m. CDT",29137,28639,29973,836
SOCO,"8/15/2024 1 a.m. CDT",28077,27013,29050,973
SOCO,"8/15/2024 2 a.m. CDT",27065,25836,27794,729
SOCO,"8/15/2024 3 a.m. CDT",26248,25040,27001,753
SOCO,"8/15/2024 4 a.m. CDT",26014,24803,26915,901
SOCO,"8/15/2024 5 a.m. CDT",26757,25171,27453,696
SOCO,"8/15/2024 6 a.m. CDT",27787,26473,28481,694
SOCO,"8/15/2024 7 a.m. CDT",27844,27234,29204,1360
SOCO,"8/15/2024 8 a.m. CDT",28766,28171,30099,1333
SOCO,"8/15/2024 9 a.m. CDT",30321,30028,31820,1499
SOCO,"8/15/2024 10 a.m. CDT",32844,32512,34513,1669
SOCO,"8/15/2024 11 a.m. CDT",35436,35060,37040,1604
SOCO,"8/15/2024 12 p.m. CDT",37679,37283,39559,1880
SOCO,"8/15/2024 1 p.m. CDT",39400,38993,41864,2464
SOCO,"8/15/2024 2 p.m. CDT",40469,40104,43165,2696
SOCO,"8/15/2024 3 p.m. CDT",41274,40877,44173,2899
SOCO,"8/15/2024 4 p.m. CDT",41792,41462,44801,3009
SOCO,"8/15/2024 5 p.m. CDT",41712,41429,44902,3190
SOCO,"8/15/2024 6 p.m. CDT",40972,40708,44064,3092
SOCO,"8/15/2024 7 p.m. CDT",39699,39478,42771,3072
SOCO,"8/15/2024 8 p.m. CDT",38371,38086,41349,2978
SOCO,"8/15/2024 9 p.m. CDT",36681,36423,39068,2387
SOCO,"8/15/2024 10 p.m. CDT",34376,33803,36046,1670
SOCO,"8/15/2024 11 p.m. CDT",31697,31125,32715,1018
SOCO,"8/16/2024 12 a.m. CDT",29408,28879,30551,1143
SOCO,"8/16/2024 1 a.m. CDT",28361,27087,29230,869
SOCO,"8/16/2024 2 a.m. CDT",27592,25825,28398,806
SOCO,"8/16/2024 3 a.m. CDT",26657,24919,27504,847
SOCO,"8/16/2024 4 a.m. CDT",26308,24574,27207,899
SOCO,"8/16/2024 5 a.m. CDT",26660,24994,27541,881
SOCO,"8/16/2024 6 a.m. CDT",27254,26037,28195,941
SOCO,"8/16/2024 7 a.m. CDT",27340,26785,28841,1501
SOCO,"8/16/2024 8 a.m. CDT",28189,27935,30107,1918
SOCO,"8/16/2024 9 a.m. CDT",30225,29906,32196,1971
SOCO,"8/16/2024 10 a.m. CDT",32755,32413,34643,1888
SOCO,"8/16/2024 11 a.m. CDT",35450,35054,37349,1899
SOCO,"8/16/2024 12 p.m. CDT",38002,37601,40208,2206
SOCO,"8/16/2024 1 p.m. CDT",39986,39591,42724,2738
SOCO,"8/16/2024 2 p.m. CDT",41276,40897,43844,2568
SOCO,"8/16/2024 3 p.m. CDT",42067,41812,44951,2884
SOCO,"8/16/2024 4 p.m. CDT",42523,42358,45509,2986
SOCO,"8/16/2024 5 p.m. CDT",42183,42026,45368,3185
SOCO,"8/16/2024 6 p.m. CDT",40974,40840,44056,3082
SOCO,"8/16/2024 7 p.m. CDT",39153,39042,41948,2795
SOCO,"8/16/2024 8 p.m. CDT",37511,37241,40131,2620
SOCO,"8/16/2024 9 p.m. CDT",35132,34938,37400,2268
SOCO,"8/16/2024 10 p.m. CDT",32712,32435,34269,1557
SOCO,"8/16/2024 11 p.m. CDT",30546,30270,31872,1326
SOCO,"8/17/2024 12 a.m. CDT",28571,28311,30013,1442
SOCO,"8/17/2024 1 a.m. CDT",27609,26655,29104,1495
SOCO,"8/17/2024 2 a.m. CDT",26797,25457,28187,1390
SOCO,"8/17/2024 3 a.m. CDT",26209,24452,27577,1368
SOCO,"8/17/2024 4 a.m. CDT",25641,23891,27189,1548
SOCO,"8/17/2024 5 a.m. CDT",24970,23673,26690,1720
SOCO,"8/17/2024 6 a.m. CDT",24927,23860,26772,1845
SOCO,"8/17/2024 7 a.m. CDT",25050,24094,27096,2046
SOCO,"8/17/2024 8 a.m. CDT",26440,25448,28461,2021
SOCO,"8/17/2024 9 a.m. CDT",28302,27886,30414,2112
SOCO,"8/17/2024 10 a.m. CDT",31242,30899,33397,2155
SOCO,"8/17/2024 11 a.m. CDT",34309,33909,36459,2150
SOCO,"8/17/2024 12 p.m. CDT",37152,36765,39226,2074
SOCO,"8/17/2024 1 p.m. CDT",39530,39107,41633,2103
SOCO,"8/17/2024 2 p.m. CDT",41225,40851,43635,2410
SOCO,"8/17/2024 3 p.m. CDT",41965,41625,44455,2490
SOCO,"8/17/2024 4 p.m. CDT",41992,41658,44516,2524
SOCO,"8/17/2024 5 p.m. CDT",41101,40855,43765,2664
SOCO,"8/17/2024 6 p.m. CDT",38863,38665,41448,2585
SOCO,"8/17/2024 7 p.m. CDT",35776,35628,37722,1946
SOCO,"8/17/2024 8 p.m. CDT",34202,33862,36031,1829
SOCO,"8/17/2024 9 p.m. CDT",32645,32303,35180,2535
SOCO,"8/17/2024 10 p.m. CDT",30843,30522,32962,2119
SOCO,"8/17/2024 11 p.m. CDT",28992,28613,30715,1723
SOCO,"8/18/2024 12 a.m. CDT",27195,26819,28856,1661
SOCO,"8/18/2024 1 a.m. CDT",25785,25324,27645,1860
SOCO,"8/18/2024 2 a.m. CDT",25376,24250,27121,1745
SOCO,"8/18/2024 3 a.m. CDT",24976,23405,26752,1776
SOCO,"8/18/2024 4 a.m. CDT",24457,22883,26292,1835
SOCO,"8/18/2024 5 a.m. CDT",24145,22599,25912,1767
SOCO,"8/18/2024 6 a.m. CDT",24291,22769,26064,1773
SOCO,"8/18/2024 7 a.m. CDT",24168,23108,26246,2078
SOCO,"8/18/2024 8 a.m. CDT",25224,24507,27533,2309
SOCO,"8/18/2024 9 a.m. CDT",27277,26484,29473,2196
SOCO,"8/18/2024 10 a.m. CDT",29312,28857,31429,2117
SOCO,"8/18/2024 11 a.m. CDT",31898,31529,34151,2253
SOCO,"8/18/2024 12 p.m. CDT",34932,34564,37236,2304
SOCO,"8/18/2024 1 p.m. CDT",37721,37310,39931,2210
SOCO,"8/18/2024 2 p.m. CDT",39720,39277,42143,2423
SOCO,"8/18/2024 3 p.m. CDT",40587,40176,42968,2381
SOCO,"8/18/2024 4 p.m. CDT",40432,40017,42977,2545
SOCO,"8/18/2024 5 p.m. CDT",40367,40010,42965,2598
SOCO,"8/18/2024 6 p.m. CDT",39368,39035,41955,2587
SOCO,"8/18/2024 7 p.m. CDT",37667,37414,40012,2345
SOCO,"8/18/2024 8 p.m. CDT",36174,35773,38106,1932
SOCO,"8/18/2024 9 p.m. CDT",34588,34113,36570,1982
SOCO,"8/18/2024 10 p.m. CDT",31847,31389,33747,1900
SOCO,"8/18/2024 11 p.m. CDT",29304,28874,30747,1443
SOCO,"8/19/2024 12 a.m. CDT",27320,26902,28862,1542
SOCO,"8/19/2024 1 a.m. CDT",26017,25286,27706,1689
SOCO,"8/19/2024 2 a.m. CDT",25190,24220,26997,1807
SOCO,"8/19/2024 3 a.m. CDT",24856,23495,26777,1921
SOCO,"8/19/2024 4 a.m. CDT",24620,23289,26636,2016
SOCO,"8/19/2024 5 a.m. CDT",24759,23809,26736,1977
SOCO,"8/19/2024 6 a.m. CDT",26043,25093,27647,1604
SOCO,"8/19/2024 7 a.m. CDT",26374,25889,28249,1875
SOCO,"8/19/2024 8 a.m. CDT",27139,26898,29241,2102
SOCO,"8/19/2024 9 a.m. CDT",28933,28629,31184,2251
SOCO,"8/19/2024 10 a.m. CDT",31184,30862,33414,2230
SOCO,"8/19/2024 11 a.m. CDT",33654,33298,35754,2100
SOCO,"8/19/2024 12 p.m. CDT",36117,35751,38301,2184
SOCO,"8/19/2024 1 p.m. CDT",38157,37781,40639,2482
SOCO,"8/19/2024 2 p.m. CDT",39481,39119,42274,2793
SOCO,"8/19/2024 3 p.m. CDT",40452,40081,43029,2577
SOCO,"8/19/2024 4 p.m. CDT",41060,40773,43648,2588
SOCO,"8/19/2024 5 p.m. CDT",41085,40795,43716,2631
SOCO,"8/19/2024 6 p.m. CDT",40324,40058,42774,2450
SOCO,"8/19/2024 7 p.m. CDT",38997,38747,41103,2106
SOCO,"8/19/2024 8 p.m. CDT",37214,36912,39306,2092
SOCO,"8/19/2024 9 p.m. CDT",35270,35018,37269,1999
SOCO,"8/19/2024 10 p.m. CDT",32323,32055,34156,1833
SOCO,"8/19/2024 11 p.m. CDT",29973,29437,31202,1229
SOCO,"8/20/2024 12 a.m. CDT",27699,27198,28989,1290
SOCO,"8/20/2024 1 a.m. CDT",26320,25443,27012,692
SOCO,"8/20/2024 2 a.m. CDT",25498,24184,26391,893
SOCO,"8/20/2024 3 a.m. CDT",24783,23429,25712,929
SOCO,"8/20/2024 4 a.m. CDT",24712,23110,25659,947
SOCO,"8/20/2024 5 a.m. CDT",25173,23502,25990,817
SOCO,"8/20/2024 6 a.m. CDT",25921,24726,26582,661
SOCO,"8/20/2024 7 a.m. CDT",26264,25439,27204,940
SOCO,"8/20/2024 8 a.m. CDT",27185,26321,28362,1177
SOCO,"8/20/2024 9 a.m. CDT",28460,27844,30052,1592
SOCO,"8/20/2024 10 a.m. CDT",30438,29990,32139,1701
SOCO,"8/20/2024 11 a.m. CDT",32572,32245,34355,1783
SOCO,"8/20/2024 12 p.m. CDT",34795,34461,36208,1413
SOCO,"8/20/2024 1 p.m. CDT",36770,36394,38136,1366
SOCO,"8/20/2024 2 p.m. CDT",38392,37986,40162,1770
SOCO,"8/20/2024 3 p.m. CDT",39620,39218,41549,1929
SOCO,"8/20/2024 4 p.m. CDT",40289,39974,42219,1930
SOCO,"8/20/2024 5 p.m. CDT",40402,40105,42385,1983
SOCO,"8/20/2024 6 p.m. CDT",39514,39243,41285,1771
SOCO,"8/20/2024 7 p.m. CDT",37898,37605,39277,1379
SOCO,"8/20/2024 8 p.m. CDT",35964,35644,37519,1555
SOCO,"8/20/2024 9 p.m. CDT",33937,33638,35527,1590
SOCO,"8/20/2024 10 p.m. CDT",31044,30780,32481,1437
SOCO,"8/20/2024 11 p.m. CDT",28437,28011,28831,394
SOCO,"8/21/2024 12 a.m. CDT",26418,25817,27019,601
SOCO,"8/21/2024 1 a.m. CDT",25596,24186,26430,834
SOCO,"8/21/2024 2 a.m. CDT",24848,23061,25806,958
SOCO,"8/21/2024 3 a.m. CDT",24136,22393,25073,937
SOCO,"8/21/2024 4 a.m. CDT",23536,22158,24401,865
SOCO,"8/21/2024 5 a.m. CDT",23972,22714,24862,890
SOCO,"8/21/2024 6 a.m. CDT",24851,24038,25970,1119
SOCO,"8/21/2024 7 a.m. CDT",25631,24802,27060,1429
SOCO,"8/21/2024 8 a.m. CDT",26314,25440,27767,1453
SOCO,"8/21/2024 9 a.m. CDT",27332,26578,28887,1555
SOCO,"8/21/2024 10 a.m. CDT",28490,28094,29967,1477
SOCO,"8/21/2024 11 a.m. CDT",30245,29794,31645,1400
SOCO,"8/21/2024 12 p.m. CDT",32188,31747,33381,1193
SOCO,"8/21/2024 1 p.m. CDT",34259,33827,35370,1111
SOCO,"8/21/2024 2 p.m. CDT",35957,35652,37220,1263
SOCO,"8/21/2024 3 p.m. CDT",37237,36883,38409,1172
SOCO,"8/21/2024 4 p.m. CDT",38145,37861,39252,1107
SOCO,"8/21/2024 5 p.m. CDT",38448,38169,39376,928
SOCO,"8/21/2024 6 p.m. CDT",37694,37486,38815,1121
SOCO,"8/21/2024 7 p.m. CDT",36468,36133,37344,876
SOCO,"8/21/2024 8 p.m. CDT",34822,34534,35700,878
SOCO,"8/21/2024 9 p.m. CDT",33169,32903,34344,1175
SOCO,"8/21/2024 10 p.m. CDT",30587,30307,31647,1060
SOCO,"8/21/2024 11 p.m. CDT",28540,28005,28833,293
SOCO,"8/22/2024 12 a.m. CDT",26558,26042,27083,525
SOCO,"8/22/2024 1 a.m. CDT",25771,24601,26161,390
SOCO,"8/22/2024 2 a.m. CDT",24919,23693,25356,437
SOCO,"8/22/2024 3 a.m. CDT",24310,23074,24907,597
SOCO,"8/22/2024 4 a.m. CDT",23994,22790,24529,535
SOCO,"8/22/2024 5 a.m. CDT",24599,23365,25060,461
SOCO,"8/22/2024 6 a.m. CDT",25982,24780,26438,456
SOCO,"8/22/2024 7 a.m. CDT",26093,25598,26993,900
SOCO,"8/22/2024 8 a.m. CDT",26761,26248,27596,835
SOCO,"8/22/2024 9 a.m. CDT",28141,27596,29164,1023
SOCO,"8/22/2024 10 a.m. CDT",29787,29221,31036,1249
SOCO,"8/22/2024 11 a.m. CDT",31600,30979,32866,1266
SOCO,"8/22/2024 12 p.m. CDT",33163,32497,34371,1208
SOCO,"8/22/2024 1 p.m. CDT",34522,34122,35987,1465
SOCO,"8/22/2024 2 p.m. CDT",35831,35380,37347,1516
SOCO,"8/22/2024 3 p.m. CDT",36745,36289,38116,1371
SOCO,"8/22/2024 4 p.m. CDT",37454,36979,38790,1336
SOCO,"8/22/2024 5 p.m. CDT",37329,36926,38535,1206
SOCO,"8/22/2024 6 p.m. CDT",36535,36182,37608,1073
SOCO,"8/22/2024 7 p.m. CDT",35169,34832,36304,1135
SOCO,"8/22/2024 8 p.m. CDT",33888,33526,34830,942
SOCO,"8/22/2024 9 p.m. CDT",32344,32017,33593,1249
SOCO,"8/22/2024 10 p.m. CDT",29934,29607,31196,1262
SOCO,"8/22/2024 11 p.m. CDT",27743,27199,28650,907
SOCO,"8/23/2024 12 a.m. CDT",26069,26314,27307,1238
SOCO,"8/23/2024 1 a.m. CDT",24972,23701,25735,763
SOCO,"8/23/2024 2 a.m. CDT",23906,22643,24448,542
SOCO,"8/23/2024 3 a.m. CDT",23202,21952,23792,590
SOCO,"8/23/2024 4 a.m. CDT",22924,21694,23519,595
SOCO,"8/23/2024 5 a.m. CDT",23252,22014,23803,551
SOCO,"8/23/2024 6 a.m. CDT",24379,23142,25063,684
SOCO,"8/23/2024 7 a.m. CDT",24667,23929,25841,1174
SOCO,"8/23/2024 8 a.m. CDT",25368,24830,26804,1436
SOCO,"8/23/2024 9 a.m. CDT",26657,26098,28649,1992
SOCO,"8/23/2024 10 a.m. CDT",28155,27561,30389,2234
SOCO,"8/23/2024 11 a.m. CDT",29830,29214,31982,2152
SOCO,"8/23/2024 12 p.m. CDT",31481,30831,33475,1994
SOCO,"8/23/2024 1 p.m. CDT",33270,32599,35351,2081
SOCO,"8/23/2024 2 p.m. CDT",34532,34113,36829,2297
SOCO,"8/23/2024 3 p.m. CDT",35686,35261,38169,2483
SOCO,"8/23/2024 4 p.m. CDT",36485,36149,38703,2218
SOCO,"8/23/2024 5 p.m. CDT",36731,36403,38827,2096
SOCO,"8/23/2024 6 p.m. CDT",35779,35480,37943,2164
SOCO,"8/23/2024 7 p.m. CDT",33913,33624,35980,2067
SOCO,"8/23/2024 8 p.m. CDT",32052,31752,33727,1675
SOCO,"8/23/2024 9 p.m. CDT",30271,29994,32145,1874
SOCO,"8/23/2024 10 p.m. CDT",28180,27875,29850,1670
SOCO,"8/23/2024 11 p.m. CDT",26385,25997,27673,1288
SOCO,"8/24/2024 12 a.m. CDT",24921,24162,25908,987
SOCO,"8/24/2024 1 a.m. CDT",23700,22705,24122,422
SOCO,"8/24/2024 2 a.m. CDT",22779,21431,23277,498
SOCO,"8/24/2024 3 a.m. CDT",22008,20662,22578,570
SOCO,"8/24/2024 4 a.m. CDT",21476,20265,21935,459
SOCO,"8/24/2024 5 a.m. CDT",21498,20298,22047,549
SOCO,"8/24/2024 6 a.m. CDT",21712,20529,22318,606
SOCO,"8/24/2024 7 a.m. CDT",21703,20775,23065,1362
SOCO,"8/24/2024 8 a.m. CDT",22721,21908,24298,1577
SOCO,"8/24/2024 9 a.m. CDT",24345,23794,26468,2123
SOCO,"8/24/2024 10 a.m. CDT",26045,25741,28277,2232
SOCO,"8/24/2024 11 a.m. CDT",28149,27797,30158,2009
SOCO,"8/24/2024 12 p.m. CDT",30277,29864,32384,2107
SOCO,"8/24/2024 1 p.m. CDT",32162,31803,34266,2104
SOCO,"8/24/2024 2 p.m. CDT",33863,33495,35973,2110
SOCO,"8/24/2024 3 p.m. CDT",35304,34929,37703,2399
SOCO,"8/24/2024 4 p.m. CDT",36395,36111,38715,2320
SOCO,"8/24/2024 5 p.m. CDT",36780,36460,39087,2307
SOCO,"8/24/2024 6 p.m. CDT",36185,35890,38415,2230
SOCO,"8/24/2024 7 p.m. CDT",34531,34229,36809,2278
SOCO,"8/24/2024 8 p.m. CDT",32596,32162,34872,2276
SOCO,"8/24/2024 9 p.m. CDT",30822,30363,32749,1927
SOCO,"8/24/2024 10 p.m. CDT",28674,28227,30228,1554
SOCO,"8/24/2024 11 p.m. CDT",26612,26083,27536,924
SOCO,"8/25/2024 12 a.m. CDT",24634,24104,25507,873
SOCO,"8/25/2024 1 a.m. CDT",23600,22586,23872,272
SOCO,"8/25/2024 2 a.m. CDT",22526,21521,22840,314
SOCO,"8/25/2024 3 a.m. CDT",22075,20698,22520,445
SOCO,"8/25/2024 4 a.m. CDT",21524,20163,22130,606
SOCO,"8/25/2024 5 a.m. CDT",21404,20060,22130,726
SOCO,"8/25/2024 6 a.m. CDT",21196,20168,22173,977
SOCO,"8/25/2024 7 a.m. CDT",21325,20380,22892,1567
SOCO,"8/25/2024 8 a.m. CDT",22584,21630,24472,1888
SOCO,"8/25/2024 9 a.m. CDT",24246,23591,26956,2710
SOCO,"8/25/2024 10 a.m. CDT",26265,25750,28915,2650
SOCO,"8/25/2024 11 a.m. CDT",28329,27971,30647,2318
SOCO,"8/25/2024 12 p.m. CDT",30883,30502,32902,2019
SOCO,"8/25/2024 1 p.m. CDT",33160,32842,35480,2320
SOCO,"8/25/2024 2 p.m. CDT",35149,34819,37571,2422
SOCO,"8/25/2024 3 p.m. CDT",36640,36288,39590,2950
SOCO,"8/25/2024 4 p.m. CDT",37777,37496,41193,3416
SOCO,"8/25/2024 5 p.m. CDT",38260,38124,41982,3722
SOCO,"8/25/2024 6 p.m. CDT",37899,37785,41531,3632
SOCO,"8/25/2024 7 p.m. CDT",36337,36260,39701,3364
SOCO,"8/25/2024 8 p.m. CDT",34608,34435,37906,3298
SOCO,"8/25/2024 9 p.m. CDT",32597,32271,35429,2832
SOCO,"8/25/2024 10 p.m. CDT",29826,29562,32286,2460
SOCO,"8/25/2024 11 p.m. CDT",27219,26984,29059,1840
SOCO,"8/26/2024 12 a.m. CDT",25403,24803,27267,1864
SOCO,"8/26/2024 1 a.m. CDT",24271,23151,25664,1393
SOCO,"8/26/2024 2 a.m. CDT",23377,22216,24791,1414
SOCO,"8/26/2024 3 a.m. CDT",22684,21559,24260,1576
SOCO,"8/26/2024 4 a.m. CDT",22594,21483,24215,1621
SOCO,"8/26/2024 5 a.m. CDT",23213,22087,24885,1672
SOCO,"8/26/2024 6 a.m. CDT",24531,23544,26125,1594
SOCO,"8/26/2024 7 a.m. CDT",25187,24604,27176,1989
SOCO,"8/26/2024 8 a.m. CDT",26175,25563,28067,1892
SOCO,"8/26/2024 9 a.m. CDT",27821,27187,30236,2415
SOCO,"8/26/2024 10 a.m. CDT",29711,29397,32281,2570
SOCO,"8/26/2024 11 a.m. CDT",32222,31891,34682,2460
SOCO,"8/26/2024 12 p.m. CDT",34764,34443,37394,2630
SOCO,"8/26/2024 1 p.m. CDT",37054,36721,39946,2892
SOCO,"8/26/2024 2 p.m. CDT",38774,38339,42425,3651
SOCO,"8/26/2024 3 p.m. CDT",40052,39583,44029,3977
SOCO,"8/26/2024 4 p.m. CDT",40917,40507,44959,4042
SOCO,"8/26/2024 5 p.m. CDT",41123,40751,45247,4124
SOCO,"8/26/2024 6 p.m. CDT",40376,40089,44221,3845
SOCO,"8/26/2024 7 p.m. CDT",38683,38379,42423,3740
SOCO,"8/26/2024 8 p.m. CDT",36933,36523,40198,3265
SOCO,"8/26/2024 9 p.m. CDT",34871,34495,37776,2905
SOCO,"8/26/2024 10 p.m. CDT",31910,31632,34012,2102
SOCO,"8/26/2024 11 p.m. CDT",29403,28885,30774,1371
SOCO,"8/27/2024 12 a.m. CDT",27385,26609,28788,1403
SOCO,"8/27/2024 1 a.m. CDT",26282,24916,27825,1543
SOCO,"8/27/2024 2 a.m. CDT",25191,23775,26757,1566
SOCO,"8/27/2024 3 a.m. CDT",24413,23010,25944,1531
SOCO,"8/27/2024 4 a.m. CDT",24547,22817,26158,1611
SOCO,"8/27/2024 5 a.m. CDT",25040,23350,26738,1698
SOCO,"8/27/2024 6 a.m. CDT",25909,24644,27518,1609
SOCO,"8/27/2024 7 a.m. CDT",26347,25487,28593,2246
SOCO,"8/27/2024 8 a.m. CDT",26878,26383,29617,2739
SOCO,"8/27/2024 9 a.m. CDT",28610,28078,31677,3067
SOCO,"8/27/2024 10 a.m. CDT",31081,30514,34334,3253
SOCO,"8/27/2024 11 a.m. CDT",34074,33476,37440,3366
SOCO,"8/27/2024 12 p.m. CDT",36603,36299,40955,4352
SOCO,"8/27/2024 1 p.m. CDT",39103,38771,43961,4858
SOCO,"8/27/2024 2 p.m. CDT",40888,40456,45572,4684
SOCO,"8/27/2024 3 p.m. CDT",42063,41540,46474,4411
SOCO,"8/27/2024 4 p.m. CDT",42871,42382,47145,4274
SOCO,"8/27/2024 5 p.m. CDT",42853,42481,47224,4371
SOCO,"8/27/2024 6 p.m. CDT",41896,41516,46197,4301
SOCO,"8/27/2024 7 p.m. CDT",40499,40136,44976,4477
SOCO,"8/27/2024 8 p.m. CDT",38882,38348,43254,4372
SOCO,"8/27/2024 9 p.m. CDT",36783,36280,41102,4319
SOCO,"8/27/2024 10 p.m. CDT",33947,33646,37623,3676
SOCO,"8/27/2024 11 p.m. CDT",31419,30865,33515,2096
SOCO,"8/28/2024 12 a.m. CDT",29119,28592,30561,1442
SOCO,"8/28/2024 1 a.m. CDT",27955,26838,29203,1248
SOCO,"8/28/2024 2 a.m. CDT",27051,25534,28400,1349
SOCO,"8/28/2024 3 a.m. CDT",26519,24797,27906,1387
SOCO,"8/28/2024 4 a.m. CDT",26148,24440,27672,1524
SOCO,"8/28/2024 5 a.m. CDT",26512,24796,27951,1439
SOCO,"8/28/2024 6 a.m. CDT",27618,26191,29008,1390
SOCO,"8/28/2024 7 a.m. CDT",28011,27064,29820,1809
SOCO,"8/28/2024 8 a.m. CDT",28617,28080,30818,2201
SOCO,"8/28/2024 9 a.m. CDT",30804,30246,33646,2842
SOCO,"8/28/2024 10 a.m. CDT",33752,33159,37147,3395
SOCO,"8/28/2024 11 a.m. CDT",36953,36334,40644,3691
SOCO,"8/28/2024 12 p.m. CDT",39484,38898,43316,3832
SOCO,"8/28/2024 1 p.m. CDT",41325,41032,45752,4427
SOCO,"8/28/2024 2 p.m. CDT",42782,42236,47068,4286
SOCO,"8/28/2024 3 p.m. CDT",43561,43220,48041,4480
SOCO,"8/28/2024 4 p.m. CDT",44027,43630,48373,4346
SOCO,"8/28/2024 5 p.m. CDT",43795,43469,48050,4255
SOCO,"8/28/2024 6 p.m. CDT",43115,42773,47463,4348
SOCO,"8/28/2024 7 p.m. CDT",41618,41300,45808,4190
SOCO,"8/28/2024 8 p.m. CDT",40353,39971,44526,4173
SOCO,"8/28/2024 9 p.m. CDT",38312,37992,42252,3940
SOCO,"8/28/2024 10 p.m. CDT",35504,35226,39180,3676
SOCO,"8/28/2024 11 p.m. CDT",33101,32561,35176,2075
SOCO,"8/29/2024 12 a.m. CDT",30835,30240,32268,1433
SOCO,"8/29/2024 1 a.m. CDT",28783,28417,29735,952
SOCO,"8/29/2024 2 a.m. CDT",27811,27112,28722,911
SOCO,"8/29/2024 3 a.m. CDT",27113,26227,28216,1103
SOCO,"8/29/2024 4 a.m. CDT",26779,25832,27878,1099
SOCO,"8/29/2024 5 a.m. CDT",27085,26256,28110,1025
SOCO,"8/29/2024 6 a.m. CDT",27935,27404,28862,927
SOCO,"8/29/2024 7 a.m. CDT",27954,28022,29535,1581
SOCO,"8/29/2024 8 a.m. CDT",27873,29069,29712,1839
SOCO,"8/29/2024 9 a.m. CDT",28975,31386,31783,2808
SOCO,"8/29/2024 10 a.m. CDT",31848,34471,34988,3140
SOCO,"8/29/2024 11 a.m. CDT",35336,37709,38783,3447
SOCO,"8/29/2024 12 p.m. CDT",37639,40225,41553,3914
SOCO,"8/29/2024 1 p.m. CDT",39012,41878,42532,3520
SOCO,"8/29/2024 2 p.m. CDT",40115,42921,43574,3459
SOCO,"8/29/2024 3 p.m. CDT",40596,43391,44373,3777
SOCO,"8/29/2024 4 p.m. CDT",41168,43659,45039,3871
SOCO,"8/29/2024 5 p.m. CDT",41191,43321,44941,3750
SOCO,"8/29/2024 6 p.m. CDT",39825,41800,43762,3937
SOCO,"8/29/2024 7 p.m. CDT",39959,39960,43762,3534
SOCO,"8/29/2024 8 p.m. CDT",37948,38767,41638,3690
SOCO,"8/29/2024 9 p.m. CDT",35890,36834,40063,4173
SOCO,"8/29/2024 10 p.m. CDT",33382,34151,36963,3581
SOCO,"8/29/2024 11 p.m. CDT",31207,31522,33300,2093
SOCO,"8/30/2024 12 a.m. CDT",28941,29246,30343,1402
SOCO,"8/30/2024 1 a.m. CDT",27829,27430,29096,1267
SOCO,"8/30/2024 2 a.m. CDT",26918,26052,28206,1288
SOCO,"8/30/2024 3 a.m. CDT",26083,25121,27533,1450
SOCO,"8/30/2024 4 a.m. CDT",25676,24730,27195,1519
SOCO,"8/30/2024 5 a.m. CDT",25932,25054,27294,1362
SOCO,"8/30/2024 6 a.m. CDT",26877,26108,28197,1320
SOCO,"8/30/2024 7 a.m. CDT",26837,26889,28534,1697
SOCO,"8/30/2024 8 a.m. CDT",26709,27964,28667,1958
SOCO,"8/30/2024 9 a.m. CDT",27687,29986,30130,2443
SOCO,"8/30/2024 10 a.m. CDT",30178,32343,33064,2886
SOCO,"8/30/2024 11 a.m. CDT",33243,34826,36090,2847
SOCO,"8/30/2024 12 p.m. CDT",35920,37200,39174,3254
SOCO,"8/30/2024 1 p.m. CDT",37705,39256,40845,3140
SOCO,"8/30/2024 2 p.m. CDT",38307,40682,41618,3311
SOCO,"8/30/2024 3 p.m. CDT",38715,41529,41989,3274
SOCO,"8/30/2024 4 p.m. CDT",38245,41939,41523,3278
SOCO,"8/30/2024 5 p.m. CDT",37241,41533,40494,3253
SOCO,"8/30/2024 6 p.m. CDT",36175,40296,39331,3156
SOCO,"8/30/2024 7 p.m. CDT",35469,38456,38510,3041
SOCO,"8/30/2024 8 p.m. CDT",34514,36634,37869,3355
SOCO,"8/30/2024 9 p.m. CDT",32912,34672,36683,3771
SOCO,"8/30/2024 10 p.m. CDT",30913,32261,34079,3166
SOCO,"8/30/2024 11 p.m. CDT",29428,29972,31530,2102
SOCO,"8/31/2024 12 a.m. CDT",27470,27883,29477,2007
SOCO,"8/31/2024 1 a.m. CDT",26702,26045,28768,2066
SOCO,"8/31/2024 2 a.m. CDT",26184,24880,28239,2055
SOCO,"8/31/2024 3 a.m. CDT",25187,23529,27136,1949
SOCO,"8/31/2024 4 a.m. CDT",24655,22677,26590,1935
SOCO,"8/31/2024 5 a.m. CDT",24474,22384,26392,1918
SOCO,"8/31/2024 6 a.m. CDT",24579,22742,26431,1852
SOCO,"8/31/2024 7 a.m. CDT",24216,22859,26353,2137
SOCO,"8/31/2024 8 a.m. CDT",25587,23910,27849,2262
SOCO,"8/31/2024 9 a.m. CDT",28140,26149,30391,2251
SOCO,"8/31/2024 10 a.m. CDT",30960,28988,33051,2091
SOCO,"8/31/2024 11 a.m. CDT",33565,31909,35589,2024
SOCO,"8/31/2024 12 p.m. CDT",36122,34694,38327,2205
SOCO,"8/31/2024 1 p.m. CDT",37520,37000,40190,2670
SOCO,"8/31/2024 2 p.m. CDT",38480,38621,41144,2664
SOCO,"8/31/2024 3 p.m. CDT",38892,39641,41722,2830
SOCO,"8/31/2024 4 p.m. CDT",39002,40134,41965,2963
SOCO,"8/31/2024 5 p.m. CDT",38309,39930,41204,2895
SOCO,"8/31/2024 6 p.m. CDT",37033,38643,40062,3029
SOCO,"8/31/2024 7 p.m. CDT",35319,36495,38138,2819
SOCO,"8/31/2024 8 p.m. CDT",34192,34538,36921,2729
SOCO,"8/31/2024 9 p.m. CDT",32662,32516,34747,2085
SOCO,"8/31/2024 10 p.m. CDT",31049,29984,32459,1410
SOCO,"8/31/2024 11 p.m. CDT",29122,27699,30766,1644
SOCO,"9/1/2024 12 a.m. CDT",27250,25664,28798,1548
