"BA Code","Timestamp (Hour Ending)","Demand (MWh)","Demand Forecast (MWh)","Net Generation (MWh)","Total Interchange (MWh)"
SOCO,"3/1/2024 12 a.m. CST",23729,23448,24364,635
SOCO,"3/1/2024 1 a.m. CST",23702,22848,24062,360
SOCO,"3/1/2024 2 a.m. CST",23329,22390,23512,183
SOCO,"3/1/2024 3 a.m. CST",23267,22343,23448,181
SOCO,"3/1/2024 4 a.m. CST",23278,22751,23393,115
SOCO,"3/1/2024 5 a.m. CST",24239,23875,24507,268
SOCO,"3/1/2024 6 a.m. CST",25956,25790,26753,797
SOCO,"3/1/2024 7 a.m. CST",27677,27577,28380,703
SOCO,"3/1/2024 8 a.m. CST",28054,27981,28541,487
SOCO,"3/1/2024 9 a.m. CST",28392,28312,28547,155
SOCO,"3/1/2024 10 a.m. CST",28797,28681,28756,-41
SOCO,"3/1/2024 11 a.m. CST",28875,28706,28806,-69
SOCO,"3/1/2024 12 p.m. CST",28818,28586,28806,-12
SOCO,"3/1/2024 1 p.m. CST",28535,28408,28507,-28
SOCO,"3/1/2024 2 p.m. CST",28326,28214,28362,36
SOCO,"3/1/2024 3 p.m. CST",28180,28074,28396,216
SOCO,"3/1/2024 4 p.m. CST",28409,28129,28648,239
SOCO,"3/1/2024 5 p.m. CST",28707,28412,29120,413
SOCO,"3/1/2024 6 p.m. CST",29008,28662,29432,424
SOCO,"3/1/2024 7 p.m. CST",28998,28560,29183,185
SOCO,"3/1/2024 8 p.m. CST",28424,27988,28348,-76
SOCO,"3/1/2024 9 p.m. CST",27532,27100,27583,51
SOCO,"3/1/2024 10 p.m. CST",26292,25912,26223,-69
SOCO,"3/1/2024 11 p.m. CST",25015,24663,25210,195
SOCO,"3/2/2024 12 a.m. CST",24170,23468,24183,13
SOCO,"3/2/2024 1 a.m. CST",23242,22652,23040,-202
SOCO,"3/2/2024 2 a.m. CST",22757,22200,22664,-93
SOCO,"3/2/2024 3 a.m. CST",22822,21909,22865,43
SOCO,"3/2/2024 4 a.m. CST",22887,21959,23088,201
SOCO,"3/2/2024 5 a.m. CST",23126,22188,23555,429
SOCO,"3/2/2024 6 a.m. CST",23596,22781,23972,376
SOCO,"3/2/2024 7 a.m. CST",23626,23408,24148,522
SOCO,"3/2/2024 8 a.m. CST",24532,24314,24924,392
SOCO,"3/2/2024 9 a.m. CST",25129,24898,25624,495
SOCO,"3/2/2024 10 a.m. CST",25180,24948,25627,447
SOCO,"3/2/2024 11 a.m. CST",24713,24484,25316,603
SOCO,"3/2/2024 12 p.m. CST",24033,23807,24583,550
SOCO,"3/2/2024 1 p.m. CST",23240,22996,23753,513
SOCO,"3/2/2024 2 p.m. CST",23115,22349,23513,398
SOCO,"3/2/2024 3 p.m. CST",22977,22005,23427,450
SOCO,"3/2/2024 4 p.m. CST",22925,21934,23409,484
SOCO,"3/2/2024 5 p.m. CST",22638,22040,23168,530
SOCO,"3/2/2024 6 p.m. CST",23013,22642,23730,717
SOCO,"3/2/2024 7 p.m. CST",23748,23425,24489,741
SOCO,"3/2/2024 8 p.m. CST",23539,23171,24227,688
SOCO,"3/2/2024 9 p.m. CST",22995,22630,23531,536
SOCO,"3/2/2024 10 p.m. CST",22312,21965,22903,591
SOCO,"3/2/2024 11 p.m. CST",21548,21185,21719,171
SOCO,"3/3/2024 12 a.m. CST",20635,20297,20548,-87
SOCO,"3/3/2024 1 a.m. CST",20042,19624,19905,-137
SOCO,"3/3/2024 2 a.m. CST",19894,19221,19645,-249
SOCO,"3/3/2024 3 a.m. CST",19606,18920,19465,-141
SOCO,"3/3/2024 4 a.m. CST",19633,18929,19754,121
SOCO,"3/3/2024 5 a.m. CST",19813,19117,20028,215
SOCO,"3/3/2024 6 a.m. CST",20245,19580,20447,202
SOCO,"3/3/2024 7 a.m. CST",20974,20356,21446,472
SOCO,"3/3/2024 8 a.m. CST",21630,21352,22094,464
SOCO,"3/3/2024 9 a.m. CST",22242,22057,22805,563
SOCO,"3/3/2024 10 a.m. CST",22381,22240,22849,468
SOCO,"3/3/2024 11 a.m. CST",22175,22064,22714,539
SOCO,"3/3/2024 12 p.m. CST",22103,21996,22814,711
SOCO,"3/3/2024 1 p.m. CST",22108,21965,22878,770
SOCO,"3/3/2024 2 p.m. CST",22104,21948,23181,1077
SOCO,"3/3/2024 3 p.m. CST",22098,21930,23239,1141
SOCO,"3/3/2024 4 p.m. CST",22215,21998,23363,1148
SOCO,"3/3/2024 5 p.m. CST",22502,22356,23488,986
SOCO,"3/3/2024 6 p.m. CST",23059,22934,24054,995
SOCO,"3/3/2024 7 p.m. CST",24015,23888,24998,983
SOCO,"3/3/2024 8 p.m. CST",23707,23575,24441,734
SOCO,"3/3/2024 9 p.m. CST",22836,22615,23402,566
SOCO,"3/3/2024 10 p.m. CST",21586,21375,22219,633
SOCO,"3/3/2024 11 p.m. CST",20336,20037,20935,599
SOCO,"3/4/2024 12 a.m. CST",19498,18936,20033,535
SOCO,"3/4/2024 1 a.m. CST",19207,18263,19572,365
SOCO,"3/4/2024 2 a.m. CST",18898,17987,19345,447
SOCO,"3/4/2024 3 a.m. CST",18821,17919,19361,540
SOCO,"3/4/2024 4 a.m. CST",19207,18310,19610,403
SOCO,"3/4/2024 5 a.m. CST",19885,19345,20253,368
SOCO,"3/4/2024 6 a.m. CST",21760,21240,22154,394
SOCO,"3/4/2024 7 a.m. CST",22845,22641,23615,770
SOCO,"3/4/2024 8 a.m. CST",23373,23177,24295,922
SOCO,"3/4/2024 9 a.m. CST",23522,23293,24366,844
SOCO,"3/4/2024 10 a.m. CST",23625,23415,24105,480
SOCO,"3/4/2024 11 a.m. CST",23691,23472,24023,332
SOCO,"3/4/2024 12 p.m. CST",23797,23604,24131,334
SOCO,"3/4/2024 1 p.m. CST",23728,23538,24151,423
SOCO,"3/4/2024 2 p.m. CST",23820,23631,24420,600
SOCO,"3/4/2024 3 p.m. CST",23809,23645,24521,712
SOCO,"3/4/2024 4 p.m. CST",23876,23768,24804,928
SOCO,"3/4/2024 5 p.m. CST",24054,23910,24974,920
SOCO,"3/4/2024 6 p.m. CST",24640,24516,25401,761
SOCO,"3/4/2024 7 p.m. CST",25449,25362,26044,595
SOCO,"3/4/2024 8 p.m. CST",25002,24897,25238,236
SOCO,"3/4/2024 9 p.m. CST",24048,23822,24252,204
SOCO,"3/4/2024 10 p.m. CST",22547,22340,23022,475
SOCO,"3/4/2024 11 p.m. CST",21619,21105,22021,402
SOCO,"3/5/2024 12 a.m. CST",20904,19984,21431,527
SOCO,"3/5/2024 1 a.m. CST",20245,19342,20732,487
SOCO,"3/5/2024 2 a.m. CST",19892,18969,20374,482
SOCO,"3/5/2024 3 a.m. CST",19679,18769,20238,559
SOCO,"3/5/2024 4 a.m. CST",19658,18981,20395,737
SOCO,"3/5/2024 5 a.m. CST",20598,20044,21401,803
SOCO,"3/5/2024 6 a.m. CST",22424,21908,23158,734
SOCO,"3/5/2024 7 a.m. CST",23372,23172,24064,692
SOCO,"3/5/2024 8 a.m. CST",23669,23459,24252,583
SOCO,"3/5/2024 9 a.m. CST",23804,23579,24311,507
SOCO,"3/5/2024 10 a.m. CST",23962,23744,24352,390
SOCO,"3/5/2024 11 a.m. CST",24015,23844,24422,407
SOCO,"3/5/2024 12 p.m. CST",24113,23978,24537,424
SOCO,"3/5/2024 1 p.m. CST",24076,23999,24446,370
SOCO,"3/5/2024 2 p.m. CST",23996,23898,24438,442
SOCO,"3/5/2024 3 p.m. CST",23860,23813,24216,356
SOCO,"3/5/2024 4 p.m. CST",24040,23979,24546,506
SOCO,"3/5/2024 5 p.m. CST",24431,24367,25005,574
SOCO,"3/5/2024 6 p.m. CST",25114,25020,25451,337
SOCO,"3/5/2024 7 p.m. CST",25676,25508,25977,301
SOCO,"3/5/2024 8 p.m. CST",25180,24981,25336,156
SOCO,"3/5/2024 9 p.m. CST",24131,23903,24371,240
SOCO,"3/5/2024 10 p.m. CST",23285,22726,23972,687
SOCO,"3/5/2024 11 p.m. CST",22238,21374,22726,488
SOCO,"3/6/2024 12 a.m. CST",21135,20250,21608,473
SOCO,"3/6/2024 1 a.m. CST",20394,19529,20866,472
SOCO,"3/6/2024 2 a.m. CST",19997,19124,20397,400
SOCO,"3/6/2024 3 a.m. CST",19876,19004,20390,514
SOCO,"3/6/2024 4 a.m. CST",20153,19298,20793,640
SOCO,"3/6/2024 5 a.m. CST",20606,20111,21239,633
SOCO,"3/6/2024 6 a.m. CST",22014,21868,22635,621
SOCO,"3/6/2024 7 a.m. CST",23165,22994,23789,624
SOCO,"3/6/2024 8 a.m. CST",23569,23244,24214,645
SOCO,"3/6/2024 9 a.m. CST",23785,23643,24640,855
SOCO,"3/6/2024 10 a.m. CST",23884,23699,24628,744
SOCO,"3/6/2024 11 a.m. CST",23949,23795,24733,784
SOCO,"3/6/2024 12 p.m. CST",23992,23826,24887,895
SOCO,"3/6/2024 1 p.m. CST",24191,23994,24931,740
SOCO,"3/6/2024 2 p.m. CST",24536,23975,25394,858
SOCO,"3/6/2024 3 p.m. CST",24560,24011,25393,833
SOCO,"3/6/2024 4 p.m. CST",24341,24102,25356,1015
SOCO,"3/6/2024 5 p.m. CST",24513,24405,25358,845
SOCO,"3/6/2024 6 p.m. CST",24702,24500,25279,577
SOCO,"3/6/2024 7 p.m. CST",25295,25105,25768,473
SOCO,"3/6/2024 8 p.m. CST",24947,24687,25233,286
SOCO,"3/6/2024 9 p.m. CST",24198,23963,24423,225
SOCO,"3/6/2024 10 p.m. CST",22870,22659,23488,618
SOCO,"3/6/2024 11 p.m. CST",21339,21111,21759,420
SOCO,"3/7/2024 12 a.m. CST",20454,20237,20748,294
SOCO,"3/7/2024 1 a.m. CST",20511,19699,20607,96
SOCO,"3/7/2024 2 a.m. CST",20312,19389,20355,43
SOCO,"3/7/2024 3 a.m. CST",20184,19296,20386,202
SOCO,"3/7/2024 4 a.m. CST",20198,19676,20412,214
SOCO,"3/7/2024 5 a.m. CST",20932,20777,21356,424
SOCO,"3/7/2024 6 a.m. CST",22942,22761,23550,608
SOCO,"3/7/2024 7 a.m. CST",24121,23970,24405,284
SOCO,"3/7/2024 8 a.m. CST",24032,23949,24619,587
SOCO,"3/7/2024 9 a.m. CST",23772,23667,24561,789
SOCO,"3/7/2024 10 a.m. CST",24013,23579,24713,700
SOCO,"3/7/2024 11 a.m. CST",23974,23534,24749,775
SOCO,"3/7/2024 12 p.m. CST",24087,23663,24717,630
SOCO,"3/7/2024 1 p.m. CST",24304,23877,24906,602
SOCO,"3/7/2024 2 p.m. CST",24533,24086,25198,665
SOCO,"3/7/2024 3 p.m. CST",24272,24216,24781,509
SOCO,"3/7/2024 4 p.m. CST",24444,24354,24957,513
SOCO,"3/7/2024 5 p.m. CST",24315,24225,24975,660
SOCO,"3/7/2024 6 p.m. CST",24448,24360,25022,574
SOCO,"3/7/2024 7 p.m. CST",25168,25122,25740,572
SOCO,"3/7/2024 8 p.m. CST",24837,24717,25253,416
SOCO,"3/7/2024 9 p.m. CST",23761,23647,24137,376
SOCO,"3/7/2024 10 p.m. CST",22433,22267,23160,727
SOCO,"3/7/2024 11 p.m. CST",21394,20899,21728,334
SOCO,"3/8/2024 12 a.m. CST",20307,19672,20600,293
SOCO,"3/8/2024 1 a.m. CST",19675,18919,20076,401
SOCO,"3/8/2024 2 a.m. CST",19216,18479,19572,356
SOCO,"3/8/2024 3 a.m. CST",19012,18286,19430,418
SOCO,"3/8/2024 4 a.m. CST",19282,18554,19663,381
SOCO,"3/8/2024 5 a.m. CST",19569,19478,20007,438
SOCO,"3/8/2024 6 a.m. CST",21208,21184,21401,193
SOCO,"3/8/2024 7 a.m. CST",22383,22390,22545,162
SOCO,"3/8/2024 8 a.m. CST",22615,22955,22884,269
SOCO,"3/8/2024 9 a.m. CST",22760,23321,23035,275
SOCO,"3/8/2024 10 a.m. CST",22981,23572,23212,231
SOCO,"3/8/2024 11 a.m. CST",22810,23538,22951,141
SOCO,"3/8/2024 12 p.m. CST",22596,23409,22688,92
SOCO,"3/8/2024 1 p.m. CST",22612,23435,22664,52
SOCO,"3/8/2024 2 p.m. CST",22761,23399,22953,192
SOCO,"3/8/2024 3 p.m. CST",22824,23263,23142,318
SOCO,"3/8/2024 4 p.m. CST",22940,23204,23435,495
SOCO,"3/8/2024 5 p.m. CST",23316,23389,24077,761
SOCO,"3/8/2024 6 p.m. CST",23884,23858,24410,526
SOCO,"3/8/2024 7 p.m. CST",24006,23981,24500,494
SOCO,"3/8/2024 8 p.m. CST",23590,23519,23566,-24
SOCO,"3/8/2024 9 p.m. CST",22861,22774,22887,26
SOCO,"3/8/2024 10 p.m. CST",21911,21853,22332,421
SOCO,"3/8/2024 11 p.m. CST",20835,20778,21116,281
SOCO,"3/9/2024 12 a.m. CST",20188,19781,20414,226
SOCO,"3/9/2024 1 a.m. CST",19970,19048,19997,27
SOCO,"3/9/2024 2 a.m. CST",19509,18585,19517,8
SOCO,"3/9/2024 3 a.m. CST",19188,18282,19202,14
SOCO,"3/9/2024 4 a.m. CST",19135,18227,19223,88
SOCO,"3/9/2024 5 a.m. CST",19309,18401,19411,102
SOCO,"3/9/2024 6 a.m. CST",19821,18990,19979,158
SOCO,"3/9/2024 7 a.m. CST",19697,19510,19782,85
SOCO,"3/9/2024 8 a.m. CST",20691,20518,20805,114
SOCO,"3/9/2024 9 a.m. CST",21704,21522,21927,223
SOCO,"3/9/2024 10 a.m. CST",22386,22195,22910,524
SOCO,"3/9/2024 11 a.m. CST",22542,22413,23131,589
SOCO,"3/9/2024 12 p.m. CST",22611,22505,23532,921
SOCO,"3/9/2024 1 p.m. CST",22423,22276,23341,918
SOCO,"3/9/2024 2 p.m. CST",22132,22013,23245,1113
SOCO,"3/9/2024 3 p.m. CST",21966,21791,23234,1268
SOCO,"3/9/2024 4 p.m. CST",21892,21684,23207,1315
SOCO,"3/9/2024 5 p.m. CST",21977,21809,23393,1416
SOCO,"3/9/2024 6 p.m. CST",22385,22249,23511,1126
SOCO,"3/9/2024 7 p.m. CST",22962,22856,23973,1011
SOCO,"3/9/2024 8 p.m. CST",22621,22436,23267,646
SOCO,"3/9/2024 9 p.m. CST",22075,21904,22721,646
SOCO,"3/9/2024 10 p.m. CST",21363,21190,21659,296
SOCO,"3/9/2024 11 p.m. CST",20595,20327,20747,152
SOCO,"3/10/2024 12 a.m. CST",20274,19577,20203,-71
SOCO,"3/10/2024 1 a.m. CST",19932,19010,20016,84
SOCO,"3/10/2024 3 a.m. CDT",19856,18804,19925,69
SOCO,"3/10/2024 4 a.m. CDT",19852,18818,19749,-103
SOCO,"3/10/2024 5 a.m. CDT",20053,19147,19999,-54
SOCO,"3/10/2024 6 a.m. CDT",20276,19864,20368,92
SOCO,"3/10/2024 7 a.m. CDT",21200,20883,21497,297
SOCO,"3/10/2024 8 a.m. CDT",22385,22054,22468,83
SOCO,"3/10/2024 9 a.m. CDT",23210,22937,23411,201
SOCO,"3/10/2024 10 a.m. CDT",23260,22971,23550,290
SOCO,"3/10/2024 11 a.m. CDT",23310,22669,23599,289
SOCO,"3/10/2024 12 p.m. CDT",22994,22332,23316,322
SOCO,"3/10/2024 1 p.m. CDT",22671,22004,22980,309
SOCO,"3/10/2024 2 p.m. CDT",22169,21664,22698,529
SOCO,"3/10/2024 3 p.m. CDT",21867,21350,22353,486
SOCO,"3/10/2024 4 p.m. CDT",21747,21263,22303,556
SOCO,"3/10/2024 5 p.m. CDT",21869,21475,22237,368
SOCO,"3/10/2024 6 p.m. CDT",21816,21759,22107,291
SOCO,"3/10/2024 7 p.m. CDT",22772,22651,23107,335
SOCO,"3/10/2024 8 p.m. CDT",24157,24111,24444,287
SOCO,"3/10/2024 9 p.m. CDT",24185,24119,24718,533
SOCO,"3/10/2024 10 p.m. CDT",23535,23356,23708,173
SOCO,"3/10/2024 11 p.m. CDT",22623,22285,22712,89
SOCO,"3/11/2024 12 a.m. CDT",22438,21530,22381,-57
SOCO,"3/11/2024 1 a.m. CDT",21935,21026,22201,266
SOCO,"3/11/2024 2 a.m. CDT",21912,21018,22086,174
SOCO,"3/11/2024 3 a.m. CDT",22228,21314,22273,45
SOCO,"3/11/2024 4 a.m. CDT",22645,22201,22515,-130
SOCO,"3/11/2024 5 a.m. CDT",24027,23809,23812,-215
SOCO,"3/11/2024 6 a.m. CDT",26788,26495,26729,-59
SOCO,"3/11/2024 7 a.m. CDT",29103,28931,29009,-94
SOCO,"3/11/2024 8 a.m. CDT",29678,29528,29805,127
SOCO,"3/11/2024 9 a.m. CDT",29076,28912,29111,35
SOCO,"3/11/2024 10 a.m. CDT",27913,27773,28077,164
SOCO,"3/11/2024 11 a.m. CDT",26707,26558,26965,258
SOCO,"3/11/2024 12 p.m. CDT",26067,25552,26359,292
SOCO,"3/11/2024 1 p.m. CDT",25468,24585,25655,187
SOCO,"3/11/2024 2 p.m. CDT",24844,23906,24930,86
SOCO,"3/11/2024 3 p.m. CDT",23823,23214,24051,228
SOCO,"3/11/2024 4 p.m. CDT",23554,22957,24065,511
SOCO,"3/11/2024 5 p.m. CDT",23222,23081,24140,918
SOCO,"3/11/2024 6 p.m. CDT",23541,23347,24477,936
SOCO,"3/11/2024 7 p.m. CDT",24369,24203,24860,491
SOCO,"3/11/2024 8 p.m. CDT",25501,25344,25669,168
SOCO,"3/11/2024 9 p.m. CDT",25157,24931,25340,183
SOCO,"3/11/2024 10 p.m. CDT",24188,23974,24458,270
SOCO,"3/11/2024 11 p.m. CDT",23483,22925,23865,382
SOCO,"3/12/2024 12 a.m. CDT",22699,22145,23284,585
SOCO,"3/12/2024 1 a.m. CDT",22321,21774,22999,678
SOCO,"3/12/2024 2 a.m. CDT",22340,21802,22964,624
SOCO,"3/12/2024 3 a.m. CDT",22691,22145,23120,429
SOCO,"3/12/2024 4 a.m. CDT",23472,22953,23961,489
SOCO,"3/12/2024 5 a.m. CDT",24749,24563,25156,407
SOCO,"3/12/2024 6 a.m. CDT",27361,27128,27605,244
SOCO,"3/12/2024 7 a.m. CDT",29424,29169,29851,427
SOCO,"3/12/2024 8 a.m. CDT",29705,29530,30318,613
SOCO,"3/12/2024 9 a.m. CDT",28484,28347,29101,617
SOCO,"3/12/2024 10 a.m. CDT",26843,26731,27518,675
SOCO,"3/12/2024 11 a.m. CDT",25734,25361,26313,579
SOCO,"3/12/2024 12 p.m. CDT",25094,24240,25601,507
SOCO,"3/12/2024 1 p.m. CDT",24567,23668,25043,476
SOCO,"3/12/2024 2 p.m. CDT",24304,23448,24862,558
SOCO,"3/12/2024 3 p.m. CDT",23866,23280,24660,794
SOCO,"3/12/2024 4 p.m. CDT",23737,23297,24780,1043
SOCO,"3/12/2024 5 p.m. CDT",23796,23343,25059,1263
SOCO,"3/12/2024 6 p.m. CDT",23602,23484,24734,1132
SOCO,"3/12/2024 7 p.m. CDT",24004,23863,24736,732
SOCO,"3/12/2024 8 p.m. CDT",24923,24771,25274,351
SOCO,"3/12/2024 9 p.m. CDT",24322,24114,24760,438
SOCO,"3/12/2024 10 p.m. CDT",23188,22983,23937,749
SOCO,"3/12/2024 11 p.m. CDT",21939,21592,22434,495
SOCO,"3/13/2024 12 a.m. CDT",21133,20597,21580,447
SOCO,"3/13/2024 1 a.m. CDT",20531,20008,20547,16
SOCO,"3/13/2024 2 a.m. CDT",20371,19835,20289,-82
SOCO,"3/13/2024 3 a.m. CDT",20479,19938,20421,-58
SOCO,"3/13/2024 4 a.m. CDT",21117,20585,21140,23
SOCO,"3/13/2024 5 a.m. CDT",22385,21861,22214,-171
SOCO,"3/13/2024 6 a.m. CDT",24499,24268,24185,-314
SOCO,"3/13/2024 7 a.m. CDT",26367,26142,26069,-298
SOCO,"3/13/2024 8 a.m. CDT",26551,26515,26230,-321
SOCO,"3/13/2024 9 a.m. CDT",25834,25736,25858,24
SOCO,"3/13/2024 10 a.m. CDT",24921,24834,25560,639
SOCO,"3/13/2024 11 a.m. CDT",24213,24102,24783,570
SOCO,"3/13/2024 12 p.m. CDT",24013,23565,24634,621
SOCO,"3/13/2024 1 p.m. CDT",23811,23357,24427,616
SOCO,"3/13/2024 2 p.m. CDT",23718,23309,24341,623
SOCO,"3/13/2024 3 p.m. CDT",23782,23346,24464,682
SOCO,"3/13/2024 4 p.m. CDT",23777,23511,24543,766
SOCO,"3/13/2024 5 p.m. CDT",23763,23669,24605,842
SOCO,"3/13/2024 6 p.m. CDT",23882,23786,24315,433
SOCO,"3/13/2024 7 p.m. CDT",24049,23911,24295,246
SOCO,"3/13/2024 8 p.m. CDT",24777,24599,24727,-50
SOCO,"3/13/2024 9 p.m. CDT",24080,23869,24165,85
SOCO,"3/13/2024 10 p.m. CDT",22757,22559,22749,-8
SOCO,"3/13/2024 11 p.m. CDT",21290,21089,20978,-312
SOCO,"3/14/2024 12 a.m. CDT",20391,19836,20165,-226
SOCO,"3/14/2024 1 a.m. CDT",20034,19172,19716,-318
SOCO,"3/14/2024 2 a.m. CDT",19734,18897,19507,-227
SOCO,"3/14/2024 3 a.m. CDT",19782,18936,19560,-222
SOCO,"3/14/2024 4 a.m. CDT",19668,19231,19555,-113
SOCO,"3/14/2024 5 a.m. CDT",20821,20480,20832,11
SOCO,"3/14/2024 6 a.m. CDT",22558,22388,22416,-142
SOCO,"3/14/2024 7 a.m. CDT",24246,24052,24570,324
SOCO,"3/14/2024 8 a.m. CDT",24466,24325,25098,632
SOCO,"3/14/2024 9 a.m. CDT",24189,24095,24926,737
SOCO,"3/14/2024 10 a.m. CDT",23829,23755,24786,957
SOCO,"3/14/2024 11 a.m. CDT",23672,23634,24636,964
SOCO,"3/14/2024 12 p.m. CDT",23729,23625,24631,902
SOCO,"3/14/2024 1 p.m. CDT",24012,23899,24838,826
SOCO,"3/14/2024 2 p.m. CDT",24500,24355,25418,918
SOCO,"3/14/2024 3 p.m. CDT",24843,24761,25765,922
SOCO,"3/14/2024 4 p.m. CDT",25351,25256,26296,945
SOCO,"3/14/2024 5 p.m. CDT",25599,25525,26639,1040
SOCO,"3/14/2024 6 p.m. CDT",25590,25473,26318,728
SOCO,"3/14/2024 7 p.m. CDT",25636,25564,26117,481
SOCO,"3/14/2024 8 p.m. CDT",26037,25924,26375,338
SOCO,"3/14/2024 9 p.m. CDT",25251,25137,25654,403
SOCO,"3/14/2024 10 p.m. CDT",23671,23425,24076,405
SOCO,"3/14/2024 11 p.m. CDT",22233,21784,22169,-64
SOCO,"3/15/2024 12 a.m. CDT",21038,20347,20766,-272
SOCO,"3/15/2024 1 a.m. CDT",20265,19341,20302,37
SOCO,"3/15/2024 2 a.m. CDT",19616,18692,19384,-232
SOCO,"3/15/2024 3 a.m. CDT",19764,18464,19643,-121
SOCO,"3/15/2024 4 a.m. CDT",19566,18504,19415,-151
SOCO,"3/15/2024 5 a.m. CDT",19712,19146,19535,-177
SOCO,"3/15/2024 6 a.m. CDT",20946,20723,21012,66
SOCO,"3/15/2024 7 a.m. CDT",22298,22080,22530,232
SOCO,"3/15/2024 8 a.m. CDT",22666,22453,23100,434
SOCO,"3/15/2024 9 a.m. CDT",23075,22904,23314,239
SOCO,"3/15/2024 10 a.m. CDT",23422,23324,23496,74
SOCO,"3/15/2024 11 a.m. CDT",23693,23560,23672,-21
SOCO,"3/15/2024 12 p.m. CDT",23920,23860,24001,81
SOCO,"3/15/2024 1 p.m. CDT",24100,24100,24411,311
SOCO,"3/15/2024 2 p.m. CDT",24119,24188,24517,398
SOCO,"3/15/2024 3 p.m. CDT",24256,24277,24650,394
SOCO,"3/15/2024 4 p.m. CDT",24132,24161,24934,802
SOCO,"3/15/2024 5 p.m. CDT",23956,23921,24698,742
SOCO,"3/15/2024 6 p.m. CDT",23820,23731,24735,915
SOCO,"3/15/2024 7 p.m. CDT",23793,23717,24685,892
SOCO,"3/15/2024 8 p.m. CDT",23940,23862,24733,793
SOCO,"3/15/2024 9 p.m. CDT",23222,23143,24017,795
SOCO,"3/15/2024 10 p.m. CDT",22349,22251,23217,868
SOCO,"3/15/2024 11 p.m. CDT",21299,21022,21866,567
SOCO,"3/16/2024 12 a.m. CDT",20236,19733,20582,346
SOCO,"3/16/2024 1 a.m. CDT",19687,18788,19917,230
SOCO,"3/16/2024 2 a.m. CDT",18970,18086,19282,312
SOCO,"3/16/2024 3 a.m. CDT",18619,17756,18958,339
SOCO,"3/16/2024 4 a.m. CDT",18516,17648,18918,402
SOCO,"3/16/2024 5 a.m. CDT",18749,17859,19178,429
SOCO,"3/16/2024 6 a.m. CDT",19157,18375,19609,452
SOCO,"3/16/2024 7 a.m. CDT",19304,19227,20043,739
SOCO,"3/16/2024 8 a.m. CDT",20098,20010,20494,396
SOCO,"3/16/2024 9 a.m. CDT",20926,20786,21193,267
SOCO,"3/16/2024 10 a.m. CDT",21571,21512,21770,199
SOCO,"3/16/2024 11 a.m. CDT",21840,21768,22121,281
SOCO,"3/16/2024 12 p.m. CDT",22014,21927,22181,167
SOCO,"3/16/2024 1 p.m. CDT",22187,22104,22475,288
SOCO,"3/16/2024 2 p.m. CDT",22450,22368,22729,279
SOCO,"3/16/2024 3 p.m. CDT",22676,22612,22966,290
SOCO,"3/16/2024 4 p.m. CDT",23011,22950,23413,402
SOCO,"3/16/2024 5 p.m. CDT",23239,23172,23729,490
SOCO,"3/16/2024 6 p.m. CDT",23106,23022,23391,285
SOCO,"3/16/2024 7 p.m. CDT",22800,22681,23011,211
SOCO,"3/16/2024 8 p.m. CDT",23073,23002,23051,-22
SOCO,"3/16/2024 9 p.m. CDT",22343,22167,22392,49
SOCO,"3/16/2024 10 p.m. CDT",21387,21210,21527,140
SOCO,"3/16/2024 11 p.m. CDT",20272,20112,20536,264
SOCO,"3/17/2024 12 a.m. CDT",19148,18989,19369,221
SOCO,"3/17/2024 1 a.m. CDT",18603,18105,18862,259
SOCO,"3/17/2024 2 a.m. CDT",18185,17650,18492,307
SOCO,"3/17/2024 3 a.m. CDT",17919,17312,18252,333
SOCO,"3/17/2024 4 a.m. CDT",18176,17266,18547,371
SOCO,"3/17/2024 5 a.m. CDT",18301,17417,18727,426
SOCO,"3/17/2024 6 a.m. CDT",18472,17840,18828,356
SOCO,"3/17/2024 7 a.m. CDT",19081,18628,19402,321
SOCO,"3/17/2024 8 a.m. CDT",19634,19545,20074,440
SOCO,"3/17/2024 9 a.m. CDT",20595,20457,20777,182
SOCO,"3/17/2024 10 a.m. CDT",21056,20908,21469,413
SOCO,"3/17/2024 11 a.m. CDT",21174,21095,21685,511
SOCO,"3/17/2024 12 p.m. CDT",21378,21268,21852,474
SOCO,"3/17/2024 1 p.m. CDT",21353,21274,21981,628
SOCO,"3/17/2024 2 p.m. CDT",21423,21336,22108,685
SOCO,"3/17/2024 3 p.m. CDT",21595,21463,22098,503
SOCO,"3/17/2024 4 p.m. CDT",21812,21693,22406,594
SOCO,"3/17/2024 5 p.m. CDT",22101,21977,22437,336
SOCO,"3/17/2024 6 p.m. CDT",22205,22113,22683,478
SOCO,"3/17/2024 7 p.m. CDT",22449,22359,22713,264
SOCO,"3/17/2024 8 p.m. CDT",23177,23068,23156,-21
SOCO,"3/17/2024 9 p.m. CDT",22726,22609,22837,111
SOCO,"3/17/2024 10 p.m. CDT",21587,21427,21715,128
SOCO,"3/17/2024 11 p.m. CDT",20259,20113,20391,132
SOCO,"3/18/2024 12 a.m. CDT",19556,19030,19851,295
SOCO,"3/18/2024 1 a.m. CDT",18961,18442,19438,477
SOCO,"3/18/2024 2 a.m. CDT",18529,18033,19131,602
SOCO,"3/18/2024 3 a.m. CDT",18534,18010,19237,703
SOCO,"3/18/2024 4 a.m. CDT",18900,18447,19652,752
SOCO,"3/18/2024 5 a.m. CDT",19831,19700,20395,564
SOCO,"3/18/2024 6 a.m. CDT",21995,21839,22636,641
SOCO,"3/18/2024 7 a.m. CDT",23773,23609,24731,958
SOCO,"3/18/2024 8 a.m. CDT",24303,24231,25206,903
SOCO,"3/18/2024 9 a.m. CDT",24527,24424,25212,685
SOCO,"3/18/2024 10 a.m. CDT",24681,24543,25203,522
SOCO,"3/18/2024 11 a.m. CDT",24966,24463,25691,725
SOCO,"3/18/2024 12 p.m. CDT",24687,24232,25655,968
SOCO,"3/18/2024 1 p.m. CDT",24386,23907,25237,851
SOCO,"3/18/2024 2 p.m. CDT",24117,23567,24958,841
SOCO,"3/18/2024 3 p.m. CDT",24218,23403,25058,840
SOCO,"3/18/2024 4 p.m. CDT",24241,23512,25290,1049
SOCO,"3/18/2024 5 p.m. CDT",23731,23666,25071,1340
SOCO,"3/18/2024 6 p.m. CDT",24148,24120,25358,1210
SOCO,"3/18/2024 7 p.m. CDT",25223,25131,26231,1008
SOCO,"3/18/2024 8 p.m. CDT",26778,26708,27292,514
SOCO,"3/18/2024 9 p.m. CDT",26688,26542,27160,472
SOCO,"3/18/2024 10 p.m. CDT",25763,25597,26344,581
SOCO,"3/18/2024 11 p.m. CDT",24663,24478,25126,463
SOCO,"3/19/2024 12 a.m. CDT",23855,23618,24227,372
SOCO,"3/19/2024 1 a.m. CDT",23976,23445,24014,38
SOCO,"3/19/2024 2 a.m. CDT",24148,23499,24186,38
SOCO,"3/19/2024 3 a.m. CDT",24924,23990,24895,-29
SOCO,"3/19/2024 4 a.m. CDT",25327,24788,25449,122
SOCO,"3/19/2024 5 a.m. CDT",26787,26538,26841,54
SOCO,"3/19/2024 6 a.m. CDT",29429,29154,28978,-451
SOCO,"3/19/2024 7 a.m. CDT",31674,31447,31152,-522
SOCO,"3/19/2024 8 a.m. CDT",32063,31904,31818,-245
SOCO,"3/19/2024 9 a.m. CDT",30930,30779,30894,-36
SOCO,"3/19/2024 10 a.m. CDT",29670,29410,30011,341
SOCO,"3/19/2024 11 a.m. CDT",28196,27818,28988,792
SOCO,"3/19/2024 12 p.m. CDT",27291,26560,28000,709
SOCO,"3/19/2024 1 p.m. CDT",26150,25423,26764,614
SOCO,"3/19/2024 2 p.m. CDT",25661,24587,26367,706
SOCO,"3/19/2024 3 p.m. CDT",24848,23664,25616,768
SOCO,"3/19/2024 4 p.m. CDT",24661,23518,25553,892
SOCO,"3/19/2024 5 p.m. CDT",24040,23392,25144,1104
SOCO,"3/19/2024 6 p.m. CDT",23885,23560,24935,1050
SOCO,"3/19/2024 7 p.m. CDT",24614,24414,25459,845
SOCO,"3/19/2024 8 p.m. CDT",26113,25968,26985,872
SOCO,"3/19/2024 9 p.m. CDT",26029,25826,26708,679
SOCO,"3/19/2024 10 p.m. CDT",25008,24809,25480,472
SOCO,"3/19/2024 11 p.m. CDT",24121,23788,24412,291
SOCO,"3/20/2024 12 a.m. CDT",23400,23071,23882,482
SOCO,"3/20/2024 1 a.m. CDT",23451,22647,23579,128
SOCO,"3/20/2024 2 a.m. CDT",23406,22590,23471,65
SOCO,"3/20/2024 3 a.m. CDT",23783,22995,23950,167
SOCO,"3/20/2024 4 a.m. CDT",24390,23775,24601,211
SOCO,"3/20/2024 5 a.m. CDT",25450,25263,25601,151
SOCO,"3/20/2024 6 a.m. CDT",28060,27837,27780,-280
SOCO,"3/20/2024 7 a.m. CDT",30018,29893,29664,-354
SOCO,"3/20/2024 8 a.m. CDT",29888,29649,29654,-234
SOCO,"3/20/2024 9 a.m. CDT",28555,28282,28912,357
SOCO,"3/20/2024 10 a.m. CDT",26952,26639,27414,462
SOCO,"3/20/2024 11 a.m. CDT",25615,25334,26038,423
SOCO,"3/20/2024 12 p.m. CDT",24872,24213,25259,387
SOCO,"3/20/2024 1 p.m. CDT",24537,23493,24940,403
SOCO,"3/20/2024 2 p.m. CDT",24115,23067,24532,417
SOCO,"3/20/2024 3 p.m. CDT",23917,22934,24368,451
SOCO,"3/20/2024 4 p.m. CDT",23868,23044,24511,643
SOCO,"3/20/2024 5 p.m. CDT",23548,23189,24392,844
SOCO,"3/20/2024 6 p.m. CDT",23424,23244,24194,770
SOCO,"3/20/2024 7 p.m. CDT",23651,23549,24171,520
SOCO,"3/20/2024 8 p.m. CDT",24463,24380,25043,580
SOCO,"3/20/2024 9 p.m. CDT",23977,23792,24436,459
SOCO,"3/20/2024 10 p.m. CDT",22725,22544,23210,485
SOCO,"3/20/2024 11 p.m. CDT",21439,21145,21756,317
SOCO,"3/21/2024 12 a.m. CDT",20538,20085,20920,382
SOCO,"3/21/2024 1 a.m. CDT",20597,19608,21449,852
SOCO,"3/21/2024 2 a.m. CDT",20425,19398,21311,886
SOCO,"3/21/2024 3 a.m. CDT",20097,19451,20940,843
SOCO,"3/21/2024 4 a.m. CDT",20639,19986,21617,978
SOCO,"3/21/2024 5 a.m. CDT",21598,21305,22502,904
SOCO,"3/21/2024 6 a.m. CDT",23852,23655,24502,650
SOCO,"3/21/2024 7 a.m. CDT",25658,25497,26758,1100
SOCO,"3/21/2024 8 a.m. CDT",25851,25664,27017,1166
SOCO,"3/21/2024 9 a.m. CDT",25171,24911,26511,1340
SOCO,"3/21/2024 10 a.m. CDT",24301,24096,25644,1343
SOCO,"3/21/2024 11 a.m. CDT",23884,23434,25398,1514
SOCO,"3/21/2024 12 p.m. CDT",23806,23187,25216,1410
SOCO,"3/21/2024 1 p.m. CDT",23823,23180,25264,1441
SOCO,"3/21/2024 2 p.m. CDT",23860,23217,25225,1365
SOCO,"3/21/2024 3 p.m. CDT",24026,23410,25355,1329
SOCO,"3/21/2024 4 p.m. CDT",23943,23626,25362,1419
SOCO,"3/21/2024 5 p.m. CDT",23988,23740,25386,1398
SOCO,"3/21/2024 6 p.m. CDT",24010,23763,25371,1361
SOCO,"3/21/2024 7 p.m. CDT",24163,23996,25264,1101
SOCO,"3/21/2024 8 p.m. CDT",24742,24624,25707,965
SOCO,"3/21/2024 9 p.m. CDT",24057,23888,24825,768
SOCO,"3/21/2024 10 p.m. CDT",22688,22523,23636,948
SOCO,"3/21/2024 11 p.m. CDT",21218,20999,22371,1153
SOCO,"3/22/2024 12 a.m. CDT",19765,19849,20999,1234
SOCO,"3/22/2024 1 a.m. CDT",19773,18932,21159,1386
SOCO,"3/22/2024 2 a.m. CDT",19309,18395,20862,1553
SOCO,"3/22/2024 3 a.m. CDT",18980,18275,20677,1697
SOCO,"3/22/2024 4 a.m. CDT",18997,18531,20763,1766
SOCO,"3/22/2024 5 a.m. CDT",19787,19357,21394,1607
SOCO,"3/22/2024 6 a.m. CDT",21120,20973,22646,1526
SOCO,"3/22/2024 7 a.m. CDT",22544,22468,24132,1588
SOCO,"3/22/2024 8 a.m. CDT",22850,22688,24181,1331
SOCO,"3/22/2024 9 a.m. CDT",23273,23079,24571,1298
SOCO,"3/22/2024 10 a.m. CDT",23524,23359,24715,1191
SOCO,"3/22/2024 11 a.m. CDT",23815,23439,24956,1141
SOCO,"3/22/2024 12 p.m. CDT",23918,23420,24912,994
SOCO,"3/22/2024 1 p.m. CDT",23674,23259,24761,1087
SOCO,"3/22/2024 2 p.m. CDT",23376,23133,24574,1198
SOCO,"3/22/2024 3 p.m. CDT",23160,23042,24294,1134
SOCO,"3/22/2024 4 p.m. CDT",23222,23025,24636,1414
SOCO,"3/22/2024 5 p.m. CDT",23458,23250,24919,1461
SOCO,"3/22/2024 6 p.m. CDT",23371,23167,24963,1592
SOCO,"3/22/2024 7 p.m. CDT",23413,23201,24845,1432
SOCO,"3/22/2024 8 p.m. CDT",23735,23652,25452,1717
SOCO,"3/22/2024 9 p.m. CDT",23122,22918,24600,1478
SOCO,"3/22/2024 10 p.m. CDT",22228,22045,23719,1491
SOCO,"3/22/2024 11 p.m. CDT",21128,20932,22436,1308
SOCO,"3/23/2024 12 a.m. CDT",20448,19868,21646,1198
SOCO,"3/23/2024 1 a.m. CDT",19736,19154,20625,889
SOCO,"3/23/2024 2 a.m. CDT",19187,18613,19934,747
SOCO,"3/23/2024 3 a.m. CDT",18931,18334,19814,883
SOCO,"3/23/2024 4 a.m. CDT",18933,18357,19875,942
SOCO,"3/23/2024 5 a.m. CDT",19081,18513,19925,844
SOCO,"3/23/2024 6 a.m. CDT",19405,19078,20210,805
SOCO,"3/23/2024 7 a.m. CDT",19971,19802,20842,871
SOCO,"3/23/2024 8 a.m. CDT",20814,20611,21831,1017
SOCO,"3/23/2024 9 a.m. CDT",21805,21556,23030,1225
SOCO,"3/23/2024 10 a.m. CDT",22206,21962,23376,1170
SOCO,"3/23/2024 11 a.m. CDT",22359,22109,23705,1346
SOCO,"3/23/2024 12 p.m. CDT",22102,21854,23470,1368
SOCO,"3/23/2024 1 p.m. CDT",21883,21630,23127,1244
SOCO,"3/23/2024 2 p.m. CDT",22046,21429,23353,1307
SOCO,"3/23/2024 3 p.m. CDT",21802,21308,23106,1304
SOCO,"3/23/2024 4 p.m. CDT",21548,21324,22725,1177
SOCO,"3/23/2024 5 p.m. CDT",21837,21463,22919,1082
SOCO,"3/23/2024 6 p.m. CDT",21848,21496,22900,1052
SOCO,"3/23/2024 7 p.m. CDT",21884,21568,22922,1038
SOCO,"3/23/2024 8 p.m. CDT",22551,22258,23451,900
SOCO,"3/23/2024 9 p.m. CDT",22340,21994,23096,756
SOCO,"3/23/2024 10 p.m. CDT",21488,21295,22180,692
SOCO,"3/23/2024 11 p.m. CDT",20627,20387,21405,778
SOCO,"3/24/2024 12 a.m. CDT",19773,19551,20613,840
SOCO,"3/24/2024 1 a.m. CDT",19601,18971,20505,904
SOCO,"3/24/2024 2 a.m. CDT",19319,18715,20113,794
SOCO,"3/24/2024 3 a.m. CDT",19387,18775,20306,919
SOCO,"3/24/2024 4 a.m. CDT",19668,19068,20653,985
SOCO,"3/24/2024 5 a.m. CDT",20041,19661,20926,885
SOCO,"3/24/2024 6 a.m. CDT",20839,20606,21796,957
SOCO,"3/24/2024 7 a.m. CDT",22122,21874,23017,895
SOCO,"3/24/2024 8 a.m. CDT",23534,23258,24902,1368
SOCO,"3/24/2024 9 a.m. CDT",24051,23595,25325,1274
SOCO,"3/24/2024 10 a.m. CDT",23576,23117,24933,1357
SOCO,"3/24/2024 11 a.m. CDT",22797,22328,24046,1249
SOCO,"3/24/2024 12 p.m. CDT",22607,21785,23758,1151
SOCO,"3/24/2024 1 p.m. CDT",22528,21343,23674,1146
SOCO,"3/24/2024 2 p.m. CDT",22310,21019,23399,1089
SOCO,"3/24/2024 3 p.m. CDT",22234,20941,23422,1188
SOCO,"3/24/2024 4 p.m. CDT",22176,21080,23560,1384
SOCO,"3/24/2024 5 p.m. CDT",21692,21418,22951,1259
SOCO,"3/24/2024 6 p.m. CDT",21836,21676,23088,1252
SOCO,"3/24/2024 7 p.m. CDT",22265,22158,23379,1114
SOCO,"3/24/2024 8 p.m. CDT",23214,23122,24173,959
SOCO,"3/24/2024 9 p.m. CDT",22961,22841,23856,895
SOCO,"3/24/2024 10 p.m. CDT",21908,21753,22914,1006
SOCO,"3/24/2024 11 p.m. CDT",20715,20549,21567,852
SOCO,"3/25/2024 12 a.m. CDT",19876,19542,20668,792
SOCO,"3/25/2024 1 a.m. CDT",19731,18979,20653,922
SOCO,"3/25/2024 2 a.m. CDT",19436,18785,20596,1160
SOCO,"3/25/2024 3 a.m. CDT",19532,18858,20698,1166
SOCO,"3/25/2024 4 a.m. CDT",19498,19406,20803,1305
SOCO,"3/25/2024 5 a.m. CDT",20667,20765,21762,1095
SOCO,"3/25/2024 6 a.m. CDT",22830,22985,23830,1000
SOCO,"3/25/2024 7 a.m. CDT",24539,24758,25837,1298
SOCO,"3/25/2024 8 a.m. CDT",25059,25280,26154,1095
SOCO,"3/25/2024 9 a.m. CDT",25339,25448,26179,840
SOCO,"3/25/2024 10 a.m. CDT",25262,25325,26164,902
SOCO,"3/25/2024 11 a.m. CDT",24924,24851,25766,842
SOCO,"3/25/2024 12 p.m. CDT",24473,24378,25460,987
SOCO,"3/25/2024 1 p.m. CDT",24555,24014,25620,1065
SOCO,"3/25/2024 2 p.m. CDT",24394,23592,25552,1158
SOCO,"3/25/2024 3 p.m. CDT",23737,23305,24971,1234
SOCO,"3/25/2024 4 p.m. CDT",23300,23162,24699,1399
SOCO,"3/25/2024 5 p.m. CDT",23393,23332,24777,1384
SOCO,"3/25/2024 6 p.m. CDT",23527,23551,25199,1672
SOCO,"3/25/2024 7 p.m. CDT",23922,24114,25291,1369
SOCO,"3/25/2024 8 p.m. CDT",24685,24890,25742,1057
SOCO,"3/25/2024 9 p.m. CDT",24106,24262,24917,811
SOCO,"3/25/2024 10 p.m. CDT",22793,22916,23706,913
SOCO,"3/25/2024 11 p.m. CDT",21314,21437,22392,1078
SOCO,"3/26/2024 12 a.m. CDT",20446,20232,21408,962
SOCO,"3/26/2024 1 a.m. CDT",19716,19512,20503,787
SOCO,"3/26/2024 2 a.m. CDT",19669,19071,20449,780
SOCO,"3/26/2024 3 a.m. CDT",19521,18925,20282,761
SOCO,"3/26/2024 4 a.m. CDT",19365,19003,20204,839
SOCO,"3/26/2024 5 a.m. CDT",19828,19961,20647,819
SOCO,"3/26/2024 6 a.m. CDT",21514,21633,22372,858
SOCO,"3/26/2024 7 a.m. CDT",22847,23063,23838,991
SOCO,"3/26/2024 8 a.m. CDT",23128,23335,24360,1232
SOCO,"3/26/2024 9 a.m. CDT",23437,23539,24576,1139
SOCO,"3/26/2024 10 a.m. CDT",23735,23828,24926,1191
SOCO,"3/26/2024 11 a.m. CDT",23747,23901,24979,1232
SOCO,"3/26/2024 12 p.m. CDT",23810,23923,25117,1307
SOCO,"3/26/2024 1 p.m. CDT",24256,23955,25371,1115
SOCO,"3/26/2024 2 p.m. CDT",24063,23899,25291,1228
SOCO,"3/26/2024 3 p.m. CDT",23673,23825,24918,1245
SOCO,"3/26/2024 4 p.m. CDT",23841,23974,25093,1252
SOCO,"3/26/2024 5 p.m. CDT",23964,24100,25570,1606
SOCO,"3/26/2024 6 p.m. CDT",24024,24149,25477,1453
SOCO,"3/26/2024 7 p.m. CDT",24174,24407,25258,1084
SOCO,"3/26/2024 8 p.m. CDT",24685,24889,25455,770
SOCO,"3/26/2024 9 p.m. CDT",24036,24244,24887,851
SOCO,"3/26/2024 10 p.m. CDT",22616,22785,23364,748
SOCO,"3/26/2024 11 p.m. CDT",21208,21369,22066,858
SOCO,"3/27/2024 12 a.m. CDT",20449,20261,21279,830
SOCO,"3/27/2024 1 a.m. CDT",20102,19508,20914,812
SOCO,"3/27/2024 2 a.m. CDT",19747,19183,20456,709
SOCO,"3/27/2024 3 a.m. CDT",19650,19087,20490,840
SOCO,"3/27/2024 4 a.m. CDT",19783,19362,20642,859
SOCO,"3/27/2024 5 a.m. CDT",19984,20152,21290,1306
SOCO,"3/27/2024 6 a.m. CDT",21872,22019,23041,1169
SOCO,"3/27/2024 7 a.m. CDT",23265,23489,24355,1090
SOCO,"3/27/2024 8 a.m. CDT",23624,23838,24895,1271
SOCO,"3/27/2024 9 a.m. CDT",23844,24012,25453,1609
SOCO,"3/27/2024 10 a.m. CDT",23726,23918,25303,1577
SOCO,"3/27/2024 11 a.m. CDT",23567,23680,25028,1461
SOCO,"3/27/2024 12 p.m. CDT",23700,23440,25220,1520
SOCO,"3/27/2024 1 p.m. CDT",23679,23357,25170,1491
SOCO,"3/27/2024 2 p.m. CDT",23677,23394,25182,1505
SOCO,"3/27/2024 3 p.m. CDT",23828,23533,25369,1541
SOCO,"3/27/2024 4 p.m. CDT",23946,23668,25559,1613
SOCO,"3/27/2024 5 p.m. CDT",23735,23719,25427,1692
SOCO,"3/27/2024 6 p.m. CDT",23545,23660,25257,1712
SOCO,"3/27/2024 7 p.m. CDT",23646,23832,25039,1393
SOCO,"3/27/2024 8 p.m. CDT",24275,24494,25552,1277
SOCO,"3/27/2024 9 p.m. CDT",23782,23992,25158,1376
SOCO,"3/27/2024 10 p.m. CDT",22402,22534,23946,1544
SOCO,"3/27/2024 11 p.m. CDT",20931,21062,22157,1226
SOCO,"3/28/2024 12 a.m. CDT",20098,19904,20869,771
SOCO,"3/28/2024 1 a.m. CDT",19811,19262,20803,992
SOCO,"3/28/2024 2 a.m. CDT",19398,18856,20473,1075
SOCO,"3/28/2024 3 a.m. CDT",19380,18809,20377,997
SOCO,"3/28/2024 4 a.m. CDT",19739,19171,20682,943
SOCO,"3/28/2024 5 a.m. CDT",20469,20284,21638,1169
SOCO,"3/28/2024 6 a.m. CDT",22093,22276,23443,1350
SOCO,"3/28/2024 7 a.m. CDT",23624,23885,25185,1561
SOCO,"3/28/2024 8 a.m. CDT",24131,24412,25925,1794
SOCO,"3/28/2024 9 a.m. CDT",24063,24401,25839,1776
SOCO,"3/28/2024 10 a.m. CDT",23766,24056,25532,1766
SOCO,"3/28/2024 11 a.m. CDT",23809,23687,25461,1652
SOCO,"3/28/2024 12 p.m. CDT",23464,23266,25309,1845
SOCO,"3/28/2024 1 p.m. CDT",23185,23034,25008,1823
SOCO,"3/28/2024 2 p.m. CDT",23403,22933,25064,1661
SOCO,"3/28/2024 3 p.m. CDT",23389,22830,25072,1683
SOCO,"3/28/2024 4 p.m. CDT",23136,22864,25020,1884
SOCO,"3/28/2024 5 p.m. CDT",22884,23018,24799,1915
SOCO,"3/28/2024 6 p.m. CDT",22874,23007,24711,1837
SOCO,"3/28/2024 7 p.m. CDT",22950,23081,24171,1221
SOCO,"3/28/2024 8 p.m. CDT",23599,23813,24900,1301
SOCO,"3/28/2024 9 p.m. CDT",23343,23540,24702,1359
SOCO,"3/28/2024 10 p.m. CDT",22209,22369,23269,1060
SOCO,"3/28/2024 11 p.m. CDT",21080,21177,22183,1103
SOCO,"3/29/2024 12 a.m. CDT",20106,20205,21221,1115
SOCO,"3/29/2024 1 a.m. CDT",20360,19680,21228,868
SOCO,"3/29/2024 2 a.m. CDT",20233,19556,21062,829
SOCO,"3/29/2024 3 a.m. CDT",20333,19645,21199,866
SOCO,"3/29/2024 4 a.m. CDT",20375,20264,21320,945
SOCO,"3/29/2024 5 a.m. CDT",21386,21484,22420,1034
SOCO,"3/29/2024 6 a.m. CDT",23412,23545,24474,1062
SOCO,"3/29/2024 7 a.m. CDT",25016,25218,26120,1104
SOCO,"3/29/2024 8 a.m. CDT",25489,25716,26998,1509
SOCO,"3/29/2024 9 a.m. CDT",24799,24970,26167,1368
SOCO,"3/29/2024 10 a.m. CDT",23795,23949,25041,1246
SOCO,"3/29/2024 11 a.m. CDT",22968,23049,24186,1218
SOCO,"3/29/2024 12 p.m. CDT",22345,22328,23662,1317
SOCO,"3/29/2024 1 p.m. CDT",22607,21970,23759,1152
SOCO,"3/29/2024 2 p.m. CDT",22554,21831,23744,1190
SOCO,"3/29/2024 3 p.m. CDT",22156,21815,23419,1263
SOCO,"3/29/2024 4 p.m. CDT",22076,21973,23292,1216
SOCO,"3/29/2024 5 p.m. CDT",22168,22238,23520,1352
SOCO,"3/29/2024 6 p.m. CDT",22075,22175,23545,1470
SOCO,"3/29/2024 7 p.m. CDT",21931,21973,22954,1023
SOCO,"3/29/2024 8 p.m. CDT",22268,22303,23018,750
SOCO,"3/29/2024 9 p.m. CDT",21912,21972,22729,817
SOCO,"3/29/2024 10 p.m. CDT",21182,21201,22053,871
SOCO,"3/29/2024 11 p.m. CDT",20217,20215,20900,683
SOCO,"3/30/2024 12 a.m. CDT",19300,19303,20183,883
SOCO,"3/30/2024 1 a.m. CDT",19220,18656,19805,585
SOCO,"3/30/2024 2 a.m. CDT",18854,18306,19563,709
SOCO,"3/30/2024 3 a.m. CDT",18519,18247,19422,903
SOCO,"3/30/2024 4 a.m. CDT",18668,18494,19739,1071
SOCO,"3/30/2024 5 a.m. CDT",19177,19001,20219,1042
SOCO,"3/30/2024 6 a.m. CDT",19967,19773,20980,1013
SOCO,"3/30/2024 7 a.m. CDT",20948,20742,21945,997
SOCO,"3/30/2024 8 a.m. CDT",21983,21723,23214,1231
SOCO,"3/30/2024 9 a.m. CDT",22349,22044,23813,1464
SOCO,"3/30/2024 10 a.m. CDT",22166,21847,23745,1579
SOCO,"3/30/2024 11 a.m. CDT",21865,21521,23675,1810
SOCO,"3/30/2024 12 p.m. CDT",21954,21239,23730,1776
SOCO,"3/30/2024 1 p.m. CDT",21836,21201,23638,1802
SOCO,"3/30/2024 2 p.m. CDT",21628,21260,23620,1992
SOCO,"3/30/2024 3 p.m. CDT",21914,21568,23812,1898
SOCO,"3/30/2024 4 p.m. CDT",22400,22112,24435,2035
SOCO,"3/30/2024 5 p.m. CDT",22777,22520,24899,2122
SOCO,"3/30/2024 6 p.m. CDT",22843,22633,24226,1383
SOCO,"3/30/2024 7 p.m. CDT",22477,22313,23868,1391
SOCO,"3/30/2024 8 p.m. CDT",22595,22432,23782,1187
SOCO,"3/30/2024 9 p.m. CDT",22225,22070,23321,1096
SOCO,"3/30/2024 10 p.m. CDT",21313,21097,22486,1173
SOCO,"3/30/2024 11 p.m. CDT",20097,19870,21085,988
SOCO,"3/31/2024 12 a.m. CDT",19343,18766,20394,1051
SOCO,"3/31/2024 1 a.m. CDT",18425,17875,19550,1125
SOCO,"3/31/2024 2 a.m. CDT",17834,17304,19048,1214
SOCO,"3/31/2024 3 a.m. CDT",17872,16996,19030,1158
SOCO,"3/31/2024 4 a.m. CDT",17423,16848,18584,1161
SOCO,"3/31/2024 5 a.m. CDT",17721,17184,18814,1093
SOCO,"3/31/2024 6 a.m. CDT",18230,17674,19245,1015
SOCO,"3/31/2024 7 a.m. CDT",18627,18450,19763,1136
SOCO,"3/31/2024 8 a.m. CDT",19736,19535,21017,1281
SOCO,"3/31/2024 9 a.m. CDT",20586,20323,22124,1538
SOCO,"3/31/2024 10 a.m. CDT",20802,20497,22368,1566
SOCO,"3/31/2024 11 a.m. CDT",21070,20616,22628,1558
SOCO,"3/31/2024 12 p.m. CDT",21657,21008,23587,1930
SOCO,"3/31/2024 1 p.m. CDT",22384,21502,24109,1725
SOCO,"3/31/2024 2 p.m. CDT",22745,21897,24231,1486
SOCO,"3/31/2024 3 p.m. CDT",23059,22215,24316,1257
SOCO,"3/31/2024 4 p.m. CDT",23037,22631,24543,1506
SOCO,"3/31/2024 5 p.m. CDT",23187,22797,24586,1399
SOCO,"3/31/2024 6 p.m. CDT",23197,22851,24198,1001
SOCO,"3/31/2024 7 p.m. CDT",23203,22894,24332,1129
SOCO,"3/31/2024 8 p.m. CDT",23669,23356,24552,883
SOCO,"3/31/2024 9 p.m. CDT",23260,22942,24152,892
SOCO,"3/31/2024 10 p.m. CDT",22009,21626,22604,595
SOCO,"3/31/2024 11 p.m. CDT",20489,20244,21217,728
SOCO,"4/1/2024 12 a.m. CDT",19554,18977,20195,641
