"BA Code","Timestamp (Hour Ending)","Demand (MWh)","Demand Forecast (MWh)","Net Generation (MWh)","Total Interchange (MWh)"
SOCO,"10/1/2024 12 a.m. CDT",22377,21657,23514,1137
SOCO,"10/1/2024 1 a.m. CDT",21334,20381,22641,1307
SOCO,"10/1/2024 2 a.m. CDT",20576,19629,22167,1591
SOCO,"10/1/2024 3 a.m. CDT",20230,19289,21717,1487
SOCO,"10/1/2024 4 a.m. CDT",20085,19179,21686,1601
SOCO,"10/1/2024 5 a.m. CDT",20590,19810,22103,1513
SOCO,"10/1/2024 6 a.m. CDT",21749,21183,23165,1416
SOCO,"10/1/2024 7 a.m. CDT",23132,22580,24766,1634
SOCO,"10/1/2024 8 a.m. CDT",23584,23019,25757,2173
SOCO,"10/1/2024 9 a.m. CDT",24307,23841,26524,2217
SOCO,"10/1/2024 10 a.m. CDT",25100,24769,27333,2233
SOCO,"10/1/2024 11 a.m. CDT",26335,25996,28625,2290
SOCO,"10/1/2024 12 p.m. CDT",27644,27270,30352,2708
SOCO,"10/1/2024 1 p.m. CDT",28903,28546,31741,2838
SOCO,"10/1/2024 2 p.m. CDT",30301,29899,33238,2937
SOCO,"10/1/2024 3 p.m. CDT",31024,30647,33810,2786
SOCO,"10/1/2024 4 p.m. CDT",31417,31043,34397,2980
SOCO,"10/1/2024 5 p.m. CDT",31366,31012,34157,2791
SOCO,"10/1/2024 6 p.m. CDT",30810,30659,33489,2679
SOCO,"10/1/2024 7 p.m. CDT",30121,29981,32822,2701
SOCO,"10/1/2024 8 p.m. CDT",29455,29193,31999,2544
SOCO,"10/1/2024 9 p.m. CDT",27890,27489,30258,2368
SOCO,"10/1/2024 10 p.m. CDT",25948,25559,28403,2455
SOCO,"10/1/2024 11 p.m. CDT",24138,23776,26097,1959
SOCO,"10/2/2024 12 a.m. CDT",22717,21994,24253,1536
SOCO,"10/2/2024 1 a.m. CDT",21912,20804,23210,1298
SOCO,"10/2/2024 2 a.m. CDT",21107,19946,22318,1211
SOCO,"10/2/2024 3 a.m. CDT",20653,19483,21876,1223
SOCO,"10/2/2024 4 a.m. CDT",20572,19410,21888,1316
SOCO,"10/2/2024 5 a.m. CDT",20876,19983,22176,1300
SOCO,"10/2/2024 6 a.m. CDT",22091,21382,23539,1448
SOCO,"10/2/2024 7 a.m. CDT",22922,22413,24518,1596
SOCO,"10/2/2024 8 a.m. CDT",23559,22962,25225,1666
SOCO,"10/2/2024 9 a.m. CDT",24382,24097,26129,1747
SOCO,"10/2/2024 10 a.m. CDT",25991,25721,27539,1548
SOCO,"10/2/2024 11 a.m. CDT",27805,27481,29405,1600
SOCO,"10/2/2024 12 p.m. CDT",29636,29248,31080,1444
SOCO,"10/2/2024 1 p.m. CDT",31701,31308,33091,1390
SOCO,"10/2/2024 2 p.m. CDT",33030,32670,34177,1147
SOCO,"10/2/2024 3 p.m. CDT",34021,33643,34965,944
SOCO,"10/2/2024 4 p.m. CDT",34451,34096,35467,1016
SOCO,"10/2/2024 5 p.m. CDT",34150,33735,35225,1075
SOCO,"10/2/2024 6 p.m. CDT",32974,32639,34026,1052
SOCO,"10/2/2024 7 p.m. CDT",31777,31650,32869,1092
SOCO,"10/2/2024 8 p.m. CDT",30705,30457,31869,1164
SOCO,"10/2/2024 9 p.m. CDT",28957,28704,30283,1326
SOCO,"10/2/2024 10 p.m. CDT",26883,26633,27946,1063
SOCO,"10/2/2024 11 p.m. CDT",24645,24424,25046,401
SOCO,"10/3/2024 12 a.m. CDT",23263,22650,23862,599
SOCO,"10/3/2024 1 a.m. CDT",21834,21386,22728,894
SOCO,"10/3/2024 2 a.m. CDT",20869,20492,21796,927
SOCO,"10/3/2024 3 a.m. CDT",20460,20059,21372,912
SOCO,"10/3/2024 4 a.m. CDT",20407,20030,21390,983
SOCO,"10/3/2024 5 a.m. CDT",20981,20589,21972,991
SOCO,"10/3/2024 6 a.m. CDT",21918,21975,22961,1043
SOCO,"10/3/2024 7 a.m. CDT",22861,23167,24074,1213
SOCO,"10/3/2024 8 a.m. CDT",22898,23662,24534,1636
SOCO,"10/3/2024 9 a.m. CDT",23244,24859,25018,1774
SOCO,"10/3/2024 10 a.m. CDT",24339,26483,25851,1512
SOCO,"10/3/2024 11 a.m. CDT",25808,28387,26888,1080
SOCO,"10/3/2024 12 p.m. CDT",27684,30238,29014,1330
SOCO,"10/3/2024 1 p.m. CDT",29194,31755,30663,1469
SOCO,"10/3/2024 2 p.m. CDT",30384,32865,31497,1113
SOCO,"10/3/2024 3 p.m. CDT",31131,33512,32210,1079
SOCO,"10/3/2024 4 p.m. CDT",31335,33738,32468,1133
SOCO,"10/3/2024 5 p.m. CDT",31391,33274,32578,1187
SOCO,"10/3/2024 6 p.m. CDT",31143,32258,32071,928
SOCO,"10/3/2024 7 p.m. CDT",30745,31504,31606,861
SOCO,"10/3/2024 8 p.m. CDT",30306,30816,31023,717
SOCO,"10/3/2024 9 p.m. CDT",28816,29411,29677,861
SOCO,"10/3/2024 10 p.m. CDT",26891,27511,27938,1047
SOCO,"10/3/2024 11 p.m. CDT",24981,25630,25668,687
SOCO,"10/4/2024 12 a.m. CDT",23856,24051,24090,234
SOCO,"10/4/2024 1 a.m. CDT",23751,22713,23531,-220
SOCO,"10/4/2024 2 a.m. CDT",22910,21880,22948,38
SOCO,"10/4/2024 3 a.m. CDT",22375,21400,22528,153
SOCO,"10/4/2024 4 a.m. CDT",22330,21329,22587,257
SOCO,"10/4/2024 5 a.m. CDT",22647,21684,22857,210
SOCO,"10/4/2024 6 a.m. CDT",23753,22473,23857,104
SOCO,"10/4/2024 7 a.m. CDT",24905,23517,25733,828
SOCO,"10/4/2024 8 a.m. CDT",25054,24167,25975,921
SOCO,"10/4/2024 9 a.m. CDT",25768,25232,26609,841
SOCO,"10/4/2024 10 a.m. CDT",26655,26438,27591,936
SOCO,"10/4/2024 11 a.m. CDT",27523,27716,28342,819
SOCO,"10/4/2024 12 p.m. CDT",28709,28922,30353,1644
SOCO,"10/4/2024 1 p.m. CDT",29567,29845,31718,2151
SOCO,"10/4/2024 2 p.m. CDT",30033,30342,32224,2191
SOCO,"10/4/2024 3 p.m. CDT",30134,30626,32326,2192
SOCO,"10/4/2024 4 p.m. CDT",30217,30555,32305,2088
SOCO,"10/4/2024 5 p.m. CDT",29805,30129,31930,2125
SOCO,"10/4/2024 6 p.m. CDT",29101,29277,31176,2075
SOCO,"10/4/2024 7 p.m. CDT",28595,28071,30657,2062
SOCO,"10/4/2024 8 p.m. CDT",27902,26716,29892,1990
SOCO,"10/4/2024 9 p.m. CDT",26929,25802,28525,1596
SOCO,"10/4/2024 10 p.m. CDT",25631,24659,26958,1327
SOCO,"10/4/2024 11 p.m. CDT",24212,23436,24745,533
SOCO,"10/5/2024 12 a.m. CDT",22796,22186,23150,354
SOCO,"10/5/2024 1 a.m. CDT",22433,21520,23041,608
SOCO,"10/5/2024 2 a.m. CDT",21678,20670,22302,624
SOCO,"10/5/2024 3 a.m. CDT",21121,20082,21689,568
SOCO,"10/5/2024 4 a.m. CDT",20797,19793,21381,584
SOCO,"10/5/2024 5 a.m. CDT",20894,19879,21347,453
SOCO,"10/5/2024 6 a.m. CDT",21090,20083,21643,553
SOCO,"10/5/2024 7 a.m. CDT",21605,20761,22396,791
SOCO,"10/5/2024 8 a.m. CDT",21984,21504,23189,1205
SOCO,"10/5/2024 9 a.m. CDT",23473,22909,24418,945
SOCO,"10/5/2024 10 a.m. CDT",24634,24404,25244,610
SOCO,"10/5/2024 11 a.m. CDT",26423,26131,27093,670
SOCO,"10/5/2024 12 p.m. CDT",28299,27973,29145,846
SOCO,"10/5/2024 1 p.m. CDT",29945,29622,30896,951
SOCO,"10/5/2024 2 p.m. CDT",31350,31016,32350,1000
SOCO,"10/5/2024 3 p.m. CDT",32097,31784,33474,1377
SOCO,"10/5/2024 4 p.m. CDT",32285,31974,33611,1326
SOCO,"10/5/2024 5 p.m. CDT",31829,31516,33038,1209
SOCO,"10/5/2024 6 p.m. CDT",30704,30541,31689,985
SOCO,"10/5/2024 7 p.m. CDT",29517,29376,30788,1271
SOCO,"10/5/2024 8 p.m. CDT",28671,28452,30026,1355
SOCO,"10/5/2024 9 p.m. CDT",27331,27130,28346,1015
SOCO,"10/5/2024 10 p.m. CDT",25708,25562,26493,785
SOCO,"10/5/2024 11 p.m. CDT",24298,23992,24702,404
SOCO,"10/6/2024 12 a.m. CDT",22767,22477,23608,841
SOCO,"10/6/2024 1 a.m. CDT",21997,21194,22797,800
SOCO,"10/6/2024 2 a.m. CDT",21591,20399,22418,827
SOCO,"10/6/2024 3 a.m. CDT",20978,19783,21800,822
SOCO,"10/6/2024 4 a.m. CDT",20630,19444,21441,811
SOCO,"10/6/2024 5 a.m. CDT",20515,19329,21425,910
SOCO,"10/6/2024 6 a.m. CDT",20684,19549,21625,941
SOCO,"10/6/2024 7 a.m. CDT",20858,20003,22082,1224
SOCO,"10/6/2024 8 a.m. CDT",21642,20761,22879,1237
SOCO,"10/6/2024 9 a.m. CDT",22758,22242,23875,1117
SOCO,"10/6/2024 10 a.m. CDT",24093,23854,24990,897
SOCO,"10/6/2024 11 a.m. CDT",25862,25611,26539,677
SOCO,"10/6/2024 12 p.m. CDT",27470,27076,28422,952
SOCO,"10/6/2024 1 p.m. CDT",29021,28506,30066,1045
SOCO,"10/6/2024 2 p.m. CDT",30234,29668,31596,1362
SOCO,"10/6/2024 3 p.m. CDT",31097,30558,33070,1973
SOCO,"10/6/2024 4 p.m. CDT",31609,31074,33766,2157
SOCO,"10/6/2024 5 p.m. CDT",31695,31209,33764,2069
SOCO,"10/6/2024 6 p.m. CDT",30842,30554,32999,2157
SOCO,"10/6/2024 7 p.m. CDT",30021,29732,32336,2315
SOCO,"10/6/2024 8 p.m. CDT",29210,28813,31283,2073
SOCO,"10/6/2024 9 p.m. CDT",27620,27278,29328,1708
SOCO,"10/6/2024 10 p.m. CDT",25748,25415,26982,1234
SOCO,"10/6/2024 11 p.m. CDT",24147,23686,25017,870
SOCO,"10/7/2024 12 a.m. CDT",22856,22060,23274,418
SOCO,"10/7/2024 1 a.m. CDT",22131,20823,22535,404
SOCO,"10/7/2024 2 a.m. CDT",21364,20015,22023,659
SOCO,"10/7/2024 3 a.m. CDT",20919,19601,21767,848
SOCO,"10/7/2024 4 a.m. CDT",20882,19536,21843,961
SOCO,"10/7/2024 5 a.m. CDT",21595,20265,22536,941
SOCO,"10/7/2024 6 a.m. CDT",22857,21677,24076,1219
SOCO,"10/7/2024 7 a.m. CDT",23558,22905,24897,1339
SOCO,"10/7/2024 8 a.m. CDT",23821,23479,25198,1377
SOCO,"10/7/2024 9 a.m. CDT",24880,24503,26076,1196
SOCO,"10/7/2024 10 a.m. CDT",26503,26083,27681,1178
SOCO,"10/7/2024 11 a.m. CDT",28295,27836,29597,1302
SOCO,"10/7/2024 12 p.m. CDT",30313,29853,31734,1421
SOCO,"10/7/2024 1 p.m. CDT",32244,31776,34005,1761
SOCO,"10/7/2024 2 p.m. CDT",33702,33135,35491,1789
SOCO,"10/7/2024 3 p.m. CDT",34615,34069,36116,1501
SOCO,"10/7/2024 4 p.m. CDT",34864,34272,36418,1554
SOCO,"10/7/2024 5 p.m. CDT",34297,33804,35966,1669
SOCO,"10/7/2024 6 p.m. CDT",32842,32598,34347,1505
SOCO,"10/7/2024 7 p.m. CDT",31501,31312,33004,1503
SOCO,"10/7/2024 8 p.m. CDT",30265,30082,31681,1416
SOCO,"10/7/2024 9 p.m. CDT",28361,28170,29845,1484
SOCO,"10/7/2024 10 p.m. CDT",26276,26112,27368,1092
SOCO,"10/7/2024 11 p.m. CDT",24268,23896,25022,754
SOCO,"10/8/2024 12 a.m. CDT",22749,22122,23476,727
SOCO,"10/8/2024 1 a.m. CDT",21916,20855,23153,1237
SOCO,"10/8/2024 2 a.m. CDT",21269,19989,22696,1427
SOCO,"10/8/2024 3 a.m. CDT",20809,19538,22382,1573
SOCO,"10/8/2024 4 a.m. CDT",20718,19458,22301,1583
SOCO,"10/8/2024 5 a.m. CDT",21258,19993,22835,1577
SOCO,"10/8/2024 6 a.m. CDT",22475,21338,23979,1504
SOCO,"10/8/2024 7 a.m. CDT",23312,22439,24995,1683
SOCO,"10/8/2024 8 a.m. CDT",23371,22785,25086,1715
SOCO,"10/8/2024 9 a.m. CDT",24038,23316,26074,2036
SOCO,"10/8/2024 10 a.m. CDT",24676,24152,26754,2078
SOCO,"10/8/2024 11 a.m. CDT",25707,25311,27838,2131
SOCO,"10/8/2024 12 p.m. CDT",26924,26536,29095,2171
SOCO,"10/8/2024 1 p.m. CDT",28343,27953,30306,1963
SOCO,"10/8/2024 2 p.m. CDT",29680,29328,31530,1850
SOCO,"10/8/2024 3 p.m. CDT",30851,30507,32831,1980
SOCO,"10/8/2024 4 p.m. CDT",31612,31252,33558,1946
SOCO,"10/8/2024 5 p.m. CDT",31560,31219,33529,1969
SOCO,"10/8/2024 6 p.m. CDT",30651,30451,32617,1966
SOCO,"10/8/2024 7 p.m. CDT",29944,29808,31861,1917
SOCO,"10/8/2024 8 p.m. CDT",29173,29012,30947,1774
SOCO,"10/8/2024 9 p.m. CDT",27555,27394,29201,1646
SOCO,"10/8/2024 10 p.m. CDT",25637,25484,27585,1948
SOCO,"10/8/2024 11 p.m. CDT",23725,23632,25383,1658
SOCO,"10/9/2024 12 a.m. CDT",22445,21977,23985,1540
SOCO,"10/9/2024 1 a.m. CDT",21384,20849,23270,1886
SOCO,"10/9/2024 2 a.m. CDT",20972,20083,22808,1836
SOCO,"10/9/2024 3 a.m. CDT",20579,19680,22502,1923
SOCO,"10/9/2024 4 a.m. CDT",20531,19631,22492,1961
SOCO,"10/9/2024 5 a.m. CDT",21172,20260,23106,1934
SOCO,"10/9/2024 6 a.m. CDT",22256,21663,24230,1974
SOCO,"10/9/2024 7 a.m. CDT",23024,22844,25221,2197
SOCO,"10/9/2024 8 a.m. CDT",23377,23259,25670,2293
SOCO,"10/9/2024 9 a.m. CDT",24100,23922,26312,2212
SOCO,"10/9/2024 10 a.m. CDT",25003,24808,27209,2206
SOCO,"10/9/2024 11 a.m. CDT",25941,25712,27958,2017
SOCO,"10/9/2024 12 p.m. CDT",27128,26849,29279,2151
SOCO,"10/9/2024 1 p.m. CDT",28278,27993,30195,1917
SOCO,"10/9/2024 2 p.m. CDT",29369,29063,31230,1861
SOCO,"10/9/2024 3 p.m. CDT",30108,29806,31959,1851
SOCO,"10/9/2024 4 p.m. CDT",30567,30246,32456,1889
SOCO,"10/9/2024 5 p.m. CDT",30446,30173,32448,2002
SOCO,"10/9/2024 6 p.m. CDT",29552,29365,31796,2244
SOCO,"10/9/2024 7 p.m. CDT",28810,28705,30927,2117
SOCO,"10/9/2024 8 p.m. CDT",27968,27701,29733,1765
SOCO,"10/9/2024 9 p.m. CDT",26575,26331,28248,1673
SOCO,"10/9/2024 10 p.m. CDT",24925,24727,26973,2048
SOCO,"10/9/2024 11 p.m. CDT",23088,22895,25162,2074
SOCO,"10/10/2024 12 a.m. CDT",21818,21347,23584,1766
SOCO,"10/10/2024 1 a.m. CDT",21487,20377,22934,1447
SOCO,"10/10/2024 2 a.m. CDT",20711,19610,22348,1637
SOCO,"10/10/2024 3 a.m. CDT",20322,19192,21973,1651
SOCO,"10/10/2024 4 a.m. CDT",20347,19217,22057,1710
SOCO,"10/10/2024 5 a.m. CDT",20893,19781,22531,1638
SOCO,"10/10/2024 6 a.m. CDT",22206,21102,24283,2077
SOCO,"10/10/2024 7 a.m. CDT",22581,22225,25232,2651
SOCO,"10/10/2024 8 a.m. CDT",23064,22813,25622,2558
SOCO,"10/10/2024 9 a.m. CDT",23581,23386,26016,2435
SOCO,"10/10/2024 10 a.m. CDT",24089,24005,26599,2510
SOCO,"10/10/2024 11 a.m. CDT",24817,24737,27077,2260
SOCO,"10/10/2024 12 p.m. CDT",25517,25416,27704,2187
SOCO,"10/10/2024 1 p.m. CDT",26462,26321,28400,1938
SOCO,"10/10/2024 2 p.m. CDT",27356,27233,29298,1942
SOCO,"10/10/2024 3 p.m. CDT",28170,28054,30212,2042
SOCO,"10/10/2024 4 p.m. CDT",28632,28489,30738,2106
SOCO,"10/10/2024 5 p.m. CDT",28581,28426,30811,2230
SOCO,"10/10/2024 6 p.m. CDT",27845,27781,30165,2320
SOCO,"10/10/2024 7 p.m. CDT",27298,27114,29192,1894
SOCO,"10/10/2024 8 p.m. CDT",26613,26423,28454,1841
SOCO,"10/10/2024 9 p.m. CDT",25242,25057,27346,2104
SOCO,"10/10/2024 10 p.m. CDT",23596,23468,25541,1945
SOCO,"10/10/2024 11 p.m. CDT",21926,21801,23518,1592
SOCO,"10/11/2024 12 a.m. CDT",20412,20420,21872,1460
SOCO,"10/11/2024 1 a.m. CDT",20501,19476,22134,1633
SOCO,"10/11/2024 2 a.m. CDT",20033,18851,21714,1681
SOCO,"10/11/2024 3 a.m. CDT",19713,18563,21342,1629
SOCO,"10/11/2024 4 a.m. CDT",19801,18662,21389,1588
SOCO,"10/11/2024 5 a.m. CDT",20357,19226,21971,1614
SOCO,"10/11/2024 6 a.m. CDT",20813,20505,22542,1729
SOCO,"10/11/2024 7 a.m. CDT",21802,21653,23664,1862
SOCO,"10/11/2024 8 a.m. CDT",22390,22163,24545,2155
SOCO,"10/11/2024 9 a.m. CDT",23436,22774,25529,2093
SOCO,"10/11/2024 10 a.m. CDT",23861,23147,26055,2194
SOCO,"10/11/2024 11 a.m. CDT",24160,23445,26411,2251
SOCO,"10/11/2024 12 p.m. CDT",24225,23846,26545,2320
SOCO,"10/11/2024 1 p.m. CDT",24787,24415,27160,2373
SOCO,"10/11/2024 2 p.m. CDT",25357,24996,28165,2808
SOCO,"10/11/2024 3 p.m. CDT",25947,25518,29034,3087
SOCO,"10/11/2024 4 p.m. CDT",26351,25939,29171,2820
SOCO,"10/11/2024 5 p.m. CDT",26338,26009,28948,2610
SOCO,"10/11/2024 6 p.m. CDT",25617,25368,28228,2611
SOCO,"10/11/2024 7 p.m. CDT",25027,24813,27460,2433
SOCO,"10/11/2024 8 p.m. CDT",24302,24033,26511,2209
SOCO,"10/11/2024 9 p.m. CDT",23434,23050,25601,2167
SOCO,"10/11/2024 10 p.m. CDT",22312,21943,24429,2117
SOCO,"10/11/2024 11 p.m. CDT",21104,20726,22693,1589
SOCO,"10/12/2024 12 a.m. CDT",19871,19524,21462,1591
SOCO,"10/12/2024 1 a.m. CDT",19592,18721,21125,1533
SOCO,"10/12/2024 2 a.m. CDT",19133,18137,20571,1438
SOCO,"10/12/2024 3 a.m. CDT",18695,17870,19957,1262
SOCO,"10/12/2024 4 a.m. CDT",18404,17800,19957,1553
SOCO,"10/12/2024 5 a.m. CDT",18570,17953,20146,1576
SOCO,"10/12/2024 6 a.m. CDT",19022,18463,20689,1667
SOCO,"10/12/2024 7 a.m. CDT",19376,19107,21390,2014
SOCO,"10/12/2024 8 a.m. CDT",20040,19873,22311,2271
SOCO,"10/12/2024 9 a.m. CDT",21358,20720,23675,2317
SOCO,"10/12/2024 10 a.m. CDT",21970,21305,24259,2289
SOCO,"10/12/2024 11 a.m. CDT",22386,21667,24831,2445
SOCO,"10/12/2024 12 p.m. CDT",22736,22149,25134,2398
SOCO,"10/12/2024 1 p.m. CDT",23144,22732,25608,2464
SOCO,"10/12/2024 2 p.m. CDT",23858,23436,26742,2884
SOCO,"10/12/2024 3 p.m. CDT",24653,24247,27938,3285
SOCO,"10/12/2024 4 p.m. CDT",25446,25052,28665,3219
SOCO,"10/12/2024 5 p.m. CDT",25646,25302,28868,3222
SOCO,"10/12/2024 6 p.m. CDT",25028,24849,28179,3151
SOCO,"10/12/2024 7 p.m. CDT",24385,24214,27326,2941
SOCO,"10/12/2024 8 p.m. CDT",23758,23535,26310,2552
SOCO,"10/12/2024 9 p.m. CDT",22749,22505,24817,2068
SOCO,"10/12/2024 10 p.m. CDT",21584,21360,23436,1852
SOCO,"10/12/2024 11 p.m. CDT",20409,20249,21678,1269
SOCO,"10/13/2024 12 a.m. CDT",19268,19133,20204,936
SOCO,"10/13/2024 1 a.m. CDT",18389,18183,19232,843
SOCO,"10/13/2024 2 a.m. CDT",18205,17655,19004,799
SOCO,"10/13/2024 3 a.m. CDT",17888,17328,18811,923
SOCO,"10/13/2024 4 a.m. CDT",17764,17220,18733,969
SOCO,"10/13/2024 5 a.m. CDT",17830,17293,18806,976
SOCO,"10/13/2024 6 a.m. CDT",18205,17640,19189,984
SOCO,"10/13/2024 7 a.m. CDT",18368,18219,19441,1073
SOCO,"10/13/2024 8 a.m. CDT",19179,18995,20409,1230
SOCO,"10/13/2024 9 a.m. CDT",20133,19876,21987,1854
SOCO,"10/13/2024 10 a.m. CDT",21351,20703,23293,1942
SOCO,"10/13/2024 11 a.m. CDT",22056,21438,24184,2128
SOCO,"10/13/2024 12 p.m. CDT",22789,22383,24975,2186
SOCO,"10/13/2024 1 p.m. CDT",24010,23574,26306,2296
SOCO,"10/13/2024 2 p.m. CDT",25266,24834,27558,2292
SOCO,"10/13/2024 3 p.m. CDT",26554,26059,28797,2243
SOCO,"10/13/2024 4 p.m. CDT",27549,27055,29717,2168
SOCO,"10/13/2024 5 p.m. CDT",27772,27399,29761,1989
SOCO,"10/13/2024 6 p.m. CDT",27285,27030,29073,1788
SOCO,"10/13/2024 7 p.m. CDT",26761,26504,28492,1731
SOCO,"10/13/2024 8 p.m. CDT",26058,25712,28012,1954
SOCO,"10/13/2024 9 p.m. CDT",24752,24413,26504,1752
SOCO,"10/13/2024 10 p.m. CDT",23268,23017,24779,1511
SOCO,"10/13/2024 11 p.m. CDT",21744,21508,22960,1216
SOCO,"10/14/2024 12 a.m. CDT",20767,20191,21912,1145
SOCO,"10/14/2024 1 a.m. CDT",20234,19254,21286,1052
SOCO,"10/14/2024 2 a.m. CDT",19636,18653,20678,1042
SOCO,"10/14/2024 3 a.m. CDT",19379,18386,20510,1131
SOCO,"10/14/2024 4 a.m. CDT",19495,18510,20616,1121
SOCO,"10/14/2024 5 a.m. CDT",20172,19209,21228,1056
SOCO,"10/14/2024 6 a.m. CDT",21161,20477,22199,1038
SOCO,"10/14/2024 7 a.m. CDT",22158,21646,23473,1315
SOCO,"10/14/2024 8 a.m. CDT",22848,22293,24368,1520
SOCO,"10/14/2024 9 a.m. CDT",24150,23173,25689,1539
SOCO,"10/14/2024 10 a.m. CDT",25088,24059,26281,1193
SOCO,"10/14/2024 11 a.m. CDT",25711,24958,26935,1224
SOCO,"10/14/2024 12 p.m. CDT",26215,25706,27723,1508
SOCO,"10/14/2024 1 p.m. CDT",26911,26566,28353,1442
SOCO,"10/14/2024 2 p.m. CDT",27584,27220,29032,1448
SOCO,"10/14/2024 3 p.m. CDT",27971,27617,29454,1483
SOCO,"10/14/2024 4 p.m. CDT",28099,27679,29774,1675
SOCO,"10/14/2024 5 p.m. CDT",27814,27509,29414,1600
SOCO,"10/14/2024 6 p.m. CDT",26980,26727,28504,1524
SOCO,"10/14/2024 7 p.m. CDT",26733,26511,28274,1541
SOCO,"10/14/2024 8 p.m. CDT",25994,25715,27571,1577
SOCO,"10/14/2024 9 p.m. CDT",24645,24411,26363,1718
SOCO,"10/14/2024 10 p.m. CDT",22984,22809,24636,1652
SOCO,"10/14/2024 11 p.m. CDT",21602,21203,23009,1407
SOCO,"10/15/2024 12 a.m. CDT",20646,19869,21797,1151
SOCO,"10/15/2024 1 a.m. CDT",20318,19068,21306,988
SOCO,"10/15/2024 2 a.m. CDT",19911,18677,21352,1441
SOCO,"10/15/2024 3 a.m. CDT",19727,18459,21205,1478
SOCO,"10/15/2024 4 a.m. CDT",19983,18735,21322,1339
SOCO,"10/15/2024 5 a.m. CDT",20576,19535,21913,1337
SOCO,"10/15/2024 6 a.m. CDT",21643,21148,23013,1370
SOCO,"10/15/2024 7 a.m. CDT",22867,22482,24304,1437
SOCO,"10/15/2024 8 a.m. CDT",23316,22882,24663,1347
SOCO,"10/15/2024 9 a.m. CDT",23376,23140,24935,1559
SOCO,"10/15/2024 10 a.m. CDT",23722,23340,25203,1481
SOCO,"10/15/2024 11 a.m. CDT",24112,23415,25630,1518
SOCO,"10/15/2024 12 p.m. CDT",24160,23470,25723,1563
SOCO,"10/15/2024 1 p.m. CDT",23971,23663,25765,1794
SOCO,"10/15/2024 2 p.m. CDT",24285,23999,26191,1906
SOCO,"10/15/2024 3 p.m. CDT",24511,24226,26393,1882
SOCO,"10/15/2024 4 p.m. CDT",24727,24456,26762,2035
SOCO,"10/15/2024 5 p.m. CDT",24739,24556,26792,2053
SOCO,"10/15/2024 6 p.m. CDT",24673,24521,26729,2056
SOCO,"10/15/2024 7 p.m. CDT",25289,25116,27141,1852
SOCO,"10/15/2024 8 p.m. CDT",25085,24858,26940,1855
SOCO,"10/15/2024 9 p.m. CDT",24104,23884,25790,1686
SOCO,"10/15/2024 10 p.m. CDT",23025,22779,24845,1820
SOCO,"10/15/2024 11 p.m. CDT",21525,21260,22766,1241
SOCO,"10/16/2024 12 a.m. CDT",20821,20188,22188,1367
SOCO,"10/16/2024 1 a.m. CDT",20480,19468,21844,1364
SOCO,"10/16/2024 2 a.m. CDT",20090,19088,21734,1644
SOCO,"10/16/2024 3 a.m. CDT",19906,18912,21573,1667
SOCO,"10/16/2024 4 a.m. CDT",20244,19242,22021,1777
SOCO,"10/16/2024 5 a.m. CDT",20855,20188,22635,1780
SOCO,"10/16/2024 6 a.m. CDT",22300,22011,24083,1783
SOCO,"10/16/2024 7 a.m. CDT",23783,23644,25636,1853
SOCO,"10/16/2024 8 a.m. CDT",24335,24152,26194,1859
SOCO,"10/16/2024 9 a.m. CDT",24499,24232,26396,1897
SOCO,"10/16/2024 10 a.m. CDT",24468,24124,26338,1870
SOCO,"10/16/2024 11 a.m. CDT",24569,23884,26259,1690
SOCO,"10/16/2024 12 p.m. CDT",24326,23642,26028,1702
SOCO,"10/16/2024 1 p.m. CDT",24176,23513,26026,1850
SOCO,"10/16/2024 2 p.m. CDT",24106,23442,25904,1798
SOCO,"10/16/2024 3 p.m. CDT",23978,23317,25821,1843
SOCO,"10/16/2024 4 p.m. CDT",24104,23453,26027,1923
SOCO,"10/16/2024 5 p.m. CDT",23806,23646,25855,2049
SOCO,"10/16/2024 6 p.m. CDT",23935,23776,25977,2042
SOCO,"10/16/2024 7 p.m. CDT",24836,24607,26636,1800
SOCO,"10/16/2024 8 p.m. CDT",24992,24837,26594,1602
SOCO,"10/16/2024 9 p.m. CDT",24405,24273,25753,1348
SOCO,"10/16/2024 10 p.m. CDT",23461,23186,25077,1616
SOCO,"10/16/2024 11 p.m. CDT",22291,22046,23513,1222
SOCO,"10/17/2024 12 a.m. CDT",21446,21189,22625,1179
SOCO,"10/17/2024 1 a.m. CDT",21710,20658,22780,1070
SOCO,"10/17/2024 2 a.m. CDT",21572,20403,22868,1296
SOCO,"10/17/2024 3 a.m. CDT",21656,20563,22819,1163
SOCO,"10/17/2024 4 a.m. CDT",21480,21046,22642,1162
SOCO,"10/17/2024 5 a.m. CDT",22588,22316,24154,1566
SOCO,"10/17/2024 6 a.m. CDT",24688,24428,26207,1519
SOCO,"10/17/2024 7 a.m. CDT",26266,26155,27718,1452
SOCO,"10/17/2024 8 a.m. CDT",26810,26609,28111,1301
SOCO,"10/17/2024 9 a.m. CDT",26331,26095,27377,1046
SOCO,"10/17/2024 10 a.m. CDT",25728,25467,27007,1279
SOCO,"10/17/2024 11 a.m. CDT",25457,24885,26670,1213
SOCO,"10/17/2024 12 p.m. CDT",24840,24252,26125,1285
SOCO,"10/17/2024 1 p.m. CDT",24844,23927,26203,1359
SOCO,"10/17/2024 2 p.m. CDT",24586,23623,25863,1277
SOCO,"10/17/2024 3 p.m. CDT",24287,23449,25620,1333
SOCO,"10/17/2024 4 p.m. CDT",23936,23290,25464,1528
SOCO,"10/17/2024 5 p.m. CDT",23710,23496,25692,1982
SOCO,"10/17/2024 6 p.m. CDT",23746,23631,25737,1991
SOCO,"10/17/2024 7 p.m. CDT",24668,24611,26521,1853
SOCO,"10/17/2024 8 p.m. CDT",24802,24708,26643,1841
SOCO,"10/17/2024 9 p.m. CDT",24262,24120,25813,1551
SOCO,"10/17/2024 10 p.m. CDT",23421,23187,25029,1608
SOCO,"10/17/2024 11 p.m. CDT",22261,22046,23445,1184
SOCO,"10/18/2024 12 a.m. CDT",21367,21151,22507,1140
SOCO,"10/18/2024 1 a.m. CDT",21725,20710,23043,1318
SOCO,"10/18/2024 2 a.m. CDT",21719,20618,23178,1459
SOCO,"10/18/2024 3 a.m. CDT",21645,20691,23203,1558
SOCO,"10/18/2024 4 a.m. CDT",21933,21172,23389,1456
SOCO,"10/18/2024 5 a.m. CDT",22618,22271,24266,1648
SOCO,"10/18/2024 6 a.m. CDT",24527,24236,25930,1403
SOCO,"10/18/2024 7 a.m. CDT",26133,25845,27448,1315
SOCO,"10/18/2024 8 a.m. CDT",26281,26109,27522,1241
SOCO,"10/18/2024 9 a.m. CDT",26104,25844,27321,1217
SOCO,"10/18/2024 10 a.m. CDT",25503,25217,26687,1184
SOCO,"10/18/2024 11 a.m. CDT",24720,24449,26251,1531
SOCO,"10/18/2024 12 p.m. CDT",24517,23893,26196,1679
SOCO,"10/18/2024 1 p.m. CDT",24643,23644,26279,1636
SOCO,"10/18/2024 2 p.m. CDT",24526,23387,26233,1707
SOCO,"10/18/2024 3 p.m. CDT",24173,23247,25949,1776
SOCO,"10/18/2024 4 p.m. CDT",23926,23152,25852,1926
SOCO,"10/18/2024 5 p.m. CDT",23912,23326,25426,1514
SOCO,"10/18/2024 6 p.m. CDT",23415,23306,25025,1610
SOCO,"10/18/2024 7 p.m. CDT",23766,23681,25248,1482
SOCO,"10/18/2024 8 p.m. CDT",23578,23443,25158,1580
SOCO,"10/18/2024 9 p.m. CDT",23034,22956,24646,1612
SOCO,"10/18/2024 10 p.m. CDT",22239,22146,23805,1566
SOCO,"10/18/2024 11 p.m. CDT",21487,21412,22715,1228
SOCO,"10/19/2024 12 a.m. CDT",20642,20568,21873,1231
SOCO,"10/19/2024 1 a.m. CDT",20452,19942,21092,640
SOCO,"10/19/2024 2 a.m. CDT",20315,19661,21045,730
SOCO,"10/19/2024 3 a.m. CDT",20186,19549,20902,716
SOCO,"10/19/2024 4 a.m. CDT",20010,19633,20925,915
SOCO,"10/19/2024 5 a.m. CDT",20257,20142,21235,978
SOCO,"10/19/2024 6 a.m. CDT",20942,20885,21888,946
SOCO,"10/19/2024 7 a.m. CDT",22012,21923,22829,817
SOCO,"10/19/2024 8 a.m. CDT",22901,22774,23756,855
SOCO,"10/19/2024 9 a.m. CDT",23270,23030,24347,1077
SOCO,"10/19/2024 10 a.m. CDT",23140,22843,24368,1228
SOCO,"10/19/2024 11 a.m. CDT",23125,22544,24416,1291
SOCO,"10/19/2024 12 p.m. CDT",22931,22267,24397,1466
SOCO,"10/19/2024 1 p.m. CDT",22717,22058,24201,1484
SOCO,"10/19/2024 2 p.m. CDT",22774,22125,24053,1279
SOCO,"10/19/2024 3 p.m. CDT",22852,22196,24347,1495
SOCO,"10/19/2024 4 p.m. CDT",22852,22390,24429,1577
SOCO,"10/19/2024 5 p.m. CDT",22946,22600,24539,1593
SOCO,"10/19/2024 6 p.m. CDT",22778,22568,24056,1278
SOCO,"10/19/2024 7 p.m. CDT",22995,22806,24104,1109
SOCO,"10/19/2024 8 p.m. CDT",22774,22540,23891,1117
SOCO,"10/19/2024 9 p.m. CDT",22209,21966,23190,981
SOCO,"10/19/2024 10 p.m. CDT",21345,21233,22473,1128
SOCO,"10/19/2024 11 p.m. CDT",20438,20325,21333,895
SOCO,"10/20/2024 12 a.m. CDT",19968,18987,20505,537
SOCO,"10/20/2024 1 a.m. CDT",19563,18962,20228,665
SOCO,"10/20/2024 2 a.m. CDT",19228,18586,19834,606
SOCO,"10/20/2024 3 a.m. CDT",19138,18483,19797,659
SOCO,"10/20/2024 4 a.m. CDT",19226,18574,19874,648
SOCO,"10/20/2024 5 a.m. CDT",19550,18966,20328,778
SOCO,"10/20/2024 6 a.m. CDT",19734,19646,20724,990
SOCO,"10/20/2024 7 a.m. CDT",20717,20599,21915,1198
SOCO,"10/20/2024 8 a.m. CDT",21768,21594,22713,945
SOCO,"10/20/2024 9 a.m. CDT",22384,22117,23469,1085
SOCO,"10/20/2024 10 a.m. CDT",22301,22012,23585,1284
SOCO,"10/20/2024 11 a.m. CDT",22366,21721,23790,1424
SOCO,"10/20/2024 12 p.m. CDT",22451,21793,23996,1545
SOCO,"10/20/2024 1 p.m. CDT",22563,21908,24274,1711
SOCO,"10/20/2024 2 p.m. CDT",22873,22236,24438,1565
SOCO,"10/20/2024 3 p.m. CDT",23484,22670,25113,1629
SOCO,"10/20/2024 4 p.m. CDT",23971,23187,25240,1269
SOCO,"10/20/2024 5 p.m. CDT",23970,23623,25334,1364
SOCO,"10/20/2024 6 p.m. CDT",23769,23532,24963,1194
SOCO,"10/20/2024 7 p.m. CDT",24186,24001,25315,1129
SOCO,"10/20/2024 8 p.m. CDT",23758,23596,24961,1203
SOCO,"10/20/2024 9 p.m. CDT",23052,22703,24168,1116
SOCO,"10/20/2024 10 p.m. CDT",21646,21489,22752,1106
SOCO,"10/20/2024 11 p.m. CDT",20274,20122,21247,973
SOCO,"10/21/2024 12 a.m. CDT",19552,19204,20502,950
SOCO,"10/21/2024 1 a.m. CDT",19672,18629,20135,463
SOCO,"10/21/2024 2 a.m. CDT",19495,18407,19680,185
SOCO,"10/21/2024 3 a.m. CDT",19506,18421,19627,121
SOCO,"10/21/2024 4 a.m. CDT",19963,18869,20191,228
SOCO,"10/21/2024 5 a.m. CDT",20598,20025,20903,305
SOCO,"10/21/2024 6 a.m. CDT",22286,22185,22753,467
SOCO,"10/21/2024 7 a.m. CDT",24072,23912,24667,595
SOCO,"10/21/2024 8 a.m. CDT",24535,24325,25276,741
SOCO,"10/21/2024 9 a.m. CDT",24594,24277,25253,659
SOCO,"10/21/2024 10 a.m. CDT",24364,24068,25017,653
SOCO,"10/21/2024 11 a.m. CDT",24561,23998,25391,830
SOCO,"10/21/2024 12 p.m. CDT",24691,24010,25789,1098
SOCO,"10/21/2024 1 p.m. CDT",24930,24299,25843,913
SOCO,"10/21/2024 2 p.m. CDT",24997,24688,26154,1157
SOCO,"10/21/2024 3 p.m. CDT",25413,25107,26361,948
SOCO,"10/21/2024 4 p.m. CDT",25861,25557,26752,891
SOCO,"10/21/2024 5 p.m. CDT",26012,25808,26931,919
SOCO,"10/21/2024 6 p.m. CDT",25675,25512,26517,842
SOCO,"10/21/2024 7 p.m. CDT",25859,25714,26582,723
SOCO,"10/21/2024 8 p.m. CDT",25494,25303,26124,630
SOCO,"10/21/2024 9 p.m. CDT",24321,24136,25098,777
SOCO,"10/21/2024 10 p.m. CDT",22840,22722,23526,686
SOCO,"10/21/2024 11 p.m. CDT",21513,21229,21881,368
SOCO,"10/22/2024 12 a.m. CDT",20698,20077,21266,568
SOCO,"10/22/2024 1 a.m. CDT",20103,19363,20581,478
SOCO,"10/22/2024 2 a.m. CDT",19819,19031,20377,558
SOCO,"10/22/2024 3 a.m. CDT",19734,18921,20220,486
SOCO,"10/22/2024 4 a.m. CDT",20389,19240,20849,460
SOCO,"10/22/2024 5 a.m. CDT",21123,20200,21137,14
SOCO,"10/22/2024 6 a.m. CDT",22542,22116,22803,261
SOCO,"10/22/2024 7 a.m. CDT",23886,23741,24208,322
SOCO,"10/22/2024 8 a.m. CDT",24152,23992,24632,480
SOCO,"10/22/2024 9 a.m. CDT",24311,24031,25258,947
SOCO,"10/22/2024 10 a.m. CDT",24693,24075,26030,1337
SOCO,"10/22/2024 11 a.m. CDT",24814,24177,26643,1829
SOCO,"10/22/2024 12 p.m. CDT",25125,24526,26972,1847
SOCO,"10/22/2024 1 p.m. CDT",25732,25083,27415,1683
SOCO,"10/22/2024 2 p.m. CDT",25895,25525,27595,1700
SOCO,"10/22/2024 3 p.m. CDT",26392,26111,27992,1600
SOCO,"10/22/2024 4 p.m. CDT",26841,26567,28142,1301
SOCO,"10/22/2024 5 p.m. CDT",27134,26960,28075,941
SOCO,"10/22/2024 6 p.m. CDT",26749,26616,28203,1454
SOCO,"10/22/2024 7 p.m. CDT",26943,26853,28432,1489
SOCO,"10/22/2024 8 p.m. CDT",26287,26072,27621,1334
SOCO,"10/22/2024 9 p.m. CDT",25123,24935,26361,1238
SOCO,"10/22/2024 10 p.m. CDT",23642,23448,25041,1399
SOCO,"10/22/2024 11 p.m. CDT",22169,21759,22903,734
SOCO,"10/23/2024 12 a.m. CDT",20873,20465,21633,760
SOCO,"10/23/2024 1 a.m. CDT",20491,19635,20873,382
SOCO,"10/23/2024 2 a.m. CDT",20127,19074,20687,560
SOCO,"10/23/2024 3 a.m. CDT",20071,18840,20582,511
SOCO,"10/23/2024 4 a.m. CDT",20255,19008,20747,492
SOCO,"10/23/2024 5 a.m. CDT",21168,19920,21670,502
SOCO,"10/23/2024 6 a.m. CDT",22124,21637,22962,838
SOCO,"10/23/2024 7 a.m. CDT",23527,23121,24032,505
SOCO,"10/23/2024 8 a.m. CDT",23601,23433,24470,869
SOCO,"10/23/2024 9 a.m. CDT",23921,23697,24774,853
SOCO,"10/23/2024 10 a.m. CDT",24362,24140,25294,932
SOCO,"10/23/2024 11 a.m. CDT",25255,24688,26160,905
SOCO,"10/23/2024 12 p.m. CDT",26033,25371,26952,919
SOCO,"10/23/2024 1 p.m. CDT",26653,26169,27459,806
SOCO,"10/23/2024 2 p.m. CDT",27195,26878,28043,848
SOCO,"10/23/2024 3 p.m. CDT",27881,27548,28523,642
SOCO,"10/23/2024 4 p.m. CDT",28272,27942,28748,476
SOCO,"10/23/2024 5 p.m. CDT",28401,28156,28824,423
SOCO,"10/23/2024 6 p.m. CDT",27759,27693,28188,429
SOCO,"10/23/2024 7 p.m. CDT",27597,27491,28086,489
SOCO,"10/23/2024 8 p.m. CDT",26748,26525,27133,385
SOCO,"10/23/2024 9 p.m. CDT",25428,25192,26055,627
SOCO,"10/23/2024 10 p.m. CDT",23905,23705,24409,504
SOCO,"10/23/2024 11 p.m. CDT",22463,22032,23051,588
SOCO,"10/24/2024 12 a.m. CDT",21339,20600,22083,744
SOCO,"10/24/2024 1 a.m. CDT",20936,19686,21361,425
SOCO,"10/24/2024 2 a.m. CDT",20411,19138,20907,496
SOCO,"10/24/2024 3 a.m. CDT",20132,18867,20671,539
SOCO,"10/24/2024 4 a.m. CDT",20135,18963,20615,480
SOCO,"10/24/2024 5 a.m. CDT",20433,19789,20853,420
SOCO,"10/24/2024 6 a.m. CDT",21852,21450,22440,588
SOCO,"10/24/2024 7 a.m. CDT",23246,22811,24180,934
SOCO,"10/24/2024 8 a.m. CDT",23416,22937,24437,1021
SOCO,"10/24/2024 9 a.m. CDT",23955,23431,24964,1009
SOCO,"10/24/2024 10 a.m. CDT",24847,24074,25866,1019
SOCO,"10/24/2024 11 a.m. CDT",25394,24736,26424,1030
SOCO,"10/24/2024 12 p.m. CDT",26177,25522,27360,1183
SOCO,"10/24/2024 1 p.m. CDT",27099,26578,28052,953
SOCO,"10/24/2024 2 p.m. CDT",27873,27590,28651,778
SOCO,"10/24/2024 3 p.m. CDT",28635,28343,29208,573
SOCO,"10/24/2024 4 p.m. CDT",28990,28709,29142,152
SOCO,"10/24/2024 5 p.m. CDT",28930,28737,29280,350
SOCO,"10/24/2024 6 p.m. CDT",27864,27757,28226,362
SOCO,"10/24/2024 7 p.m. CDT",27455,27309,27755,300
SOCO,"10/24/2024 8 p.m. CDT",26605,26416,27226,621
SOCO,"10/24/2024 9 p.m. CDT",25325,25170,25879,554
SOCO,"10/24/2024 10 p.m. CDT",23624,23500,24209,585
SOCO,"10/24/2024 11 p.m. CDT",22183,21895,22999,816
SOCO,"10/25/2024 12 a.m. CDT",20834,20555,21801,967
SOCO,"10/25/2024 1 a.m. CDT",20589,19587,21419,830
SOCO,"10/25/2024 2 a.m. CDT",20151,18960,20855,704
SOCO,"10/25/2024 3 a.m. CDT",19905,18697,20602,697
SOCO,"10/25/2024 4 a.m. CDT",19982,18798,20709,727
SOCO,"10/25/2024 5 a.m. CDT",20460,19534,21377,917
SOCO,"10/25/2024 6 a.m. CDT",21562,21184,22681,1119
SOCO,"10/25/2024 7 a.m. CDT",22971,22529,24361,1390
SOCO,"10/25/2024 8 a.m. CDT",23332,22892,24822,1490
SOCO,"10/25/2024 9 a.m. CDT",23839,23339,25452,1613
SOCO,"10/25/2024 10 a.m. CDT",24163,23816,26010,1847
SOCO,"10/25/2024 11 a.m. CDT",25040,24397,26685,1645
SOCO,"10/25/2024 12 p.m. CDT",25704,25043,27263,1559
SOCO,"10/25/2024 1 p.m. CDT",26728,26130,28043,1315
SOCO,"10/25/2024 2 p.m. CDT",27508,27145,28798,1290
SOCO,"10/25/2024 3 p.m. CDT",28262,27975,29718,1456
SOCO,"10/25/2024 4 p.m. CDT",28781,28513,30182,1401
SOCO,"10/25/2024 5 p.m. CDT",28585,28437,30149,1564
SOCO,"10/25/2024 6 p.m. CDT",27423,27332,28927,1504
SOCO,"10/25/2024 7 p.m. CDT",26843,26792,28677,1834
SOCO,"10/25/2024 8 p.m. CDT",25825,25638,27391,1566
SOCO,"10/25/2024 9 p.m. CDT",24698,24459,26270,1572
SOCO,"10/25/2024 10 p.m. CDT",23453,23208,24978,1525
SOCO,"10/25/2024 11 p.m. CDT",22205,21883,23486,1281
SOCO,"10/26/2024 12 a.m. CDT",20854,20531,22018,1164
SOCO,"10/26/2024 1 a.m. CDT",20158,19510,21256,1098
SOCO,"10/26/2024 2 a.m. CDT",19651,18774,20865,1214
SOCO,"10/26/2024 3 a.m. CDT",19161,18305,20445,1284
SOCO,"10/26/2024 4 a.m. CDT",19346,18109,20534,1188
SOCO,"10/26/2024 5 a.m. CDT",19431,18270,20662,1231
SOCO,"10/26/2024 6 a.m. CDT",19414,18683,20791,1377
SOCO,"10/26/2024 7 a.m. CDT",20073,19403,21461,1388
SOCO,"10/26/2024 8 a.m. CDT",20891,20193,22386,1495
SOCO,"10/26/2024 9 a.m. CDT",21950,21177,23733,1783
SOCO,"10/26/2024 10 a.m. CDT",22799,22217,24724,1925
SOCO,"10/26/2024 11 a.m. CDT",23535,23146,25467,1932
SOCO,"10/26/2024 12 p.m. CDT",24598,24333,26599,2001
SOCO,"10/26/2024 1 p.m. CDT",25864,25603,27502,1638
SOCO,"10/26/2024 2 p.m. CDT",27021,26742,28278,1257
SOCO,"10/26/2024 3 p.m. CDT",27914,27628,29212,1298
SOCO,"10/26/2024 4 p.m. CDT",28326,28052,29621,1295
SOCO,"10/26/2024 5 p.m. CDT",28157,27977,29639,1482
SOCO,"10/26/2024 6 p.m. CDT",26999,26905,28538,1539
SOCO,"10/26/2024 7 p.m. CDT",26295,26170,27905,1610
SOCO,"10/26/2024 8 p.m. CDT",25170,25029,26687,1517
SOCO,"10/26/2024 9 p.m. CDT",24151,23893,25599,1448
SOCO,"10/26/2024 10 p.m. CDT",22837,22585,24029,1192
SOCO,"10/26/2024 11 p.m. CDT",21616,21289,22704,1088
SOCO,"10/27/2024 12 a.m. CDT",20345,20027,21333,988
SOCO,"10/27/2024 1 a.m. CDT",19307,18954,20538,1231
SOCO,"10/27/2024 2 a.m. CDT",18572,18126,19773,1201
SOCO,"10/27/2024 3 a.m. CDT",18450,17710,19618,1168
SOCO,"10/27/2024 4 a.m. CDT",18565,17528,19579,1014
SOCO,"10/27/2024 5 a.m. CDT",18624,17584,19568,944
SOCO,"10/27/2024 6 a.m. CDT",18754,17931,19670,916
SOCO,"10/27/2024 7 a.m. CDT",19194,18591,20308,1114
SOCO,"10/27/2024 8 a.m. CDT",19989,19339,21362,1373
SOCO,"10/27/2024 9 a.m. CDT",21157,20432,22959,1802
SOCO,"10/27/2024 10 a.m. CDT",21912,21315,23758,1846
SOCO,"10/27/2024 11 a.m. CDT",22435,22115,24371,1936
SOCO,"10/27/2024 12 p.m. CDT",23271,22924,25094,1823
SOCO,"10/27/2024 1 p.m. CDT",24249,23881,25926,1677
SOCO,"10/27/2024 2 p.m. CDT",25213,24823,26575,1362
SOCO,"10/27/2024 3 p.m. CDT",25846,25486,27121,1275
SOCO,"10/27/2024 4 p.m. CDT",25976,25767,27310,1334
SOCO,"10/27/2024 5 p.m. CDT",25873,25668,27127,1254
SOCO,"10/27/2024 6 p.m. CDT",25558,25455,26833,1275
SOCO,"10/27/2024 7 p.m. CDT",25726,25643,26975,1249
SOCO,"10/27/2024 8 p.m. CDT",25178,25039,26350,1172
SOCO,"10/27/2024 9 p.m. CDT",24062,23962,25144,1082
SOCO,"10/27/2024 10 p.m. CDT",22609,22503,23551,942
SOCO,"10/27/2024 11 p.m. CDT",21101,20960,21791,690
SOCO,"10/28/2024 12 a.m. CDT",19807,19707,20697,890
SOCO,"10/28/2024 1 a.m. CDT",19597,18811,20582,985
SOCO,"10/28/2024 2 a.m. CDT",19246,18291,20323,1077
SOCO,"10/28/2024 3 a.m. CDT",19023,18081,20268,1245
SOCO,"10/28/2024 4 a.m. CDT",19198,18300,20499,1301
SOCO,"10/28/2024 5 a.m. CDT",19746,19147,20679,933
SOCO,"10/28/2024 6 a.m. CDT",21025,20837,22102,1077
SOCO,"10/28/2024 7 a.m. CDT",22494,22376,23678,1184
SOCO,"10/28/2024 8 a.m. CDT",22901,22777,24066,1165
SOCO,"10/28/2024 9 a.m. CDT",23403,23272,24554,1151
SOCO,"10/28/2024 10 a.m. CDT",23950,23686,24858,908
SOCO,"10/28/2024 11 a.m. CDT",24167,23907,24863,696
SOCO,"10/28/2024 12 p.m. CDT",24971,24347,25679,708
SOCO,"10/28/2024 1 p.m. CDT",25504,24844,26432,928
SOCO,"10/28/2024 2 p.m. CDT",25910,25219,26729,819
SOCO,"10/28/2024 3 p.m. CDT",26090,25618,26946,856
SOCO,"10/28/2024 4 p.m. CDT",26174,25820,27246,1072
SOCO,"10/28/2024 5 p.m. CDT",26213,25943,27287,1074
SOCO,"10/28/2024 6 p.m. CDT",25941,25897,27216,1275
SOCO,"10/28/2024 7 p.m. CDT",26467,26431,27473,1006
SOCO,"10/28/2024 8 p.m. CDT",25902,25826,26781,879
SOCO,"10/28/2024 9 p.m. CDT",24764,24682,25579,815
SOCO,"10/28/2024 10 p.m. CDT",23253,23218,24190,937
SOCO,"10/28/2024 11 p.m. CDT",21747,21685,22802,1055
SOCO,"10/29/2024 12 a.m. CDT",20505,20434,21426,921
SOCO,"10/29/2024 1 a.m. CDT",20393,19551,20915,522
SOCO,"10/29/2024 2 a.m. CDT",20038,19051,20723,685
SOCO,"10/29/2024 3 a.m. CDT",19802,18816,20480,678
SOCO,"10/29/2024 4 a.m. CDT",19996,19031,20633,637
SOCO,"10/29/2024 5 a.m. CDT",20870,19878,21562,692
SOCO,"10/29/2024 6 a.m. CDT",21825,21597,22634,809
SOCO,"10/29/2024 7 a.m. CDT",23145,23070,24058,913
SOCO,"10/29/2024 8 a.m. CDT",23392,23281,24441,1049
SOCO,"10/29/2024 9 a.m. CDT",23694,23557,24770,1076
SOCO,"10/29/2024 10 a.m. CDT",24082,23937,24965,883
SOCO,"10/29/2024 11 a.m. CDT",24524,24349,25415,891
SOCO,"10/29/2024 12 p.m. CDT",25368,24834,26280,912
SOCO,"10/29/2024 1 p.m. CDT",25989,25479,26939,950
SOCO,"10/29/2024 2 p.m. CDT",26545,26018,27595,1050
SOCO,"10/29/2024 3 p.m. CDT",26636,26402,27590,954
SOCO,"10/29/2024 4 p.m. CDT",26985,26846,27728,743
SOCO,"10/29/2024 5 p.m. CDT",26829,26789,27772,943
SOCO,"10/29/2024 6 p.m. CDT",26449,26293,27344,895
SOCO,"10/29/2024 7 p.m. CDT",26792,26646,27160,368
SOCO,"10/29/2024 8 p.m. CDT",26270,26072,26878,608
SOCO,"10/29/2024 9 p.m. CDT",25107,25025,25869,762
SOCO,"10/29/2024 10 p.m. CDT",23607,23547,24407,800
SOCO,"10/29/2024 11 p.m. CDT",22219,21992,22793,574
SOCO,"10/30/2024 12 a.m. CDT",21094,20747,21543,449
SOCO,"10/30/2024 1 a.m. CDT",20637,19919,21110,473
SOCO,"10/30/2024 2 a.m. CDT",20251,19327,20884,633
SOCO,"10/30/2024 3 a.m. CDT",20021,19100,20570,549
SOCO,"10/30/2024 4 a.m. CDT",19913,19266,20430,517
SOCO,"10/30/2024 5 a.m. CDT",20665,20095,21018,353
SOCO,"10/30/2024 6 a.m. CDT",21915,21712,22180,265
SOCO,"10/30/2024 7 a.m. CDT",23462,23255,23804,342
SOCO,"10/30/2024 8 a.m. CDT",23744,23556,24318,574
SOCO,"10/30/2024 9 a.m. CDT",24113,23864,24755,642
SOCO,"10/30/2024 10 a.m. CDT",24759,24427,25457,698
SOCO,"10/30/2024 11 a.m. CDT",25424,25086,25852,428
SOCO,"10/30/2024 12 p.m. CDT",26513,25816,27153,640
SOCO,"10/30/2024 1 p.m. CDT",27229,26644,28009,780
SOCO,"10/30/2024 2 p.m. CDT",27715,27143,28686,971
SOCO,"10/30/2024 3 p.m. CDT",27702,27434,28699,997
SOCO,"10/30/2024 4 p.m. CDT",27986,27764,29049,1063
SOCO,"10/30/2024 5 p.m. CDT",27975,27859,28833,858
SOCO,"10/30/2024 6 p.m. CDT",27631,27621,28675,1044
SOCO,"10/30/2024 7 p.m. CDT",27912,27769,28814,902
SOCO,"10/30/2024 8 p.m. CDT",27355,27182,28321,966
SOCO,"10/30/2024 9 p.m. CDT",26250,26112,27210,960
SOCO,"10/30/2024 10 p.m. CDT",24722,24588,25519,797
SOCO,"10/30/2024 11 p.m. CDT",23159,22911,23812,653
SOCO,"10/31/2024 12 a.m. CDT",22128,21530,22846,718
SOCO,"10/31/2024 1 a.m. CDT",21573,20548,22040,467
SOCO,"10/31/2024 2 a.m. CDT",20848,19835,21250,402
SOCO,"10/31/2024 3 a.m. CDT",20458,19443,20900,442
SOCO,"10/31/2024 4 a.m. CDT",20479,19482,20965,486
SOCO,"10/31/2024 5 a.m. CDT",20912,20240,21469,557
SOCO,"10/31/2024 6 a.m. CDT",22096,21836,22679,583
SOCO,"10/31/2024 7 a.m. CDT",23528,23300,24334,806
SOCO,"10/31/2024 8 a.m. CDT",23894,23652,24934,1040
SOCO,"10/31/2024 9 a.m. CDT",24431,24107,25777,1346
SOCO,"10/31/2024 10 a.m. CDT",25612,24867,26756,1144
SOCO,"10/31/2024 11 a.m. CDT",26475,25708,27495,1020
SOCO,"10/31/2024 12 p.m. CDT",27138,26602,28114,976
SOCO,"10/31/2024 1 p.m. CDT",27816,27411,28856,1040
SOCO,"10/31/2024 2 p.m. CDT",28391,28122,29558,1167
SOCO,"10/31/2024 3 p.m. CDT",28936,28591,30161,1225
SOCO,"10/31/2024 4 p.m. CDT",29131,28845,30414,1283
SOCO,"10/31/2024 5 p.m. CDT",28748,28594,29908,1160
SOCO,"10/31/2024 6 p.m. CDT",27564,27518,28377,813
SOCO,"10/31/2024 7 p.m. CDT",26934,26873,27568,634
SOCO,"10/31/2024 8 p.m. CDT",26187,26106,26996,809
SOCO,"10/31/2024 9 p.m. CDT",25577,25510,26512,935
SOCO,"10/31/2024 10 p.m. CDT",24346,24262,25229,883
SOCO,"10/31/2024 11 p.m. CDT",22918,22673,23411,493
SOCO,"11/1/2024 12 a.m. CDT",21995,21383,22472,477
