"BA Code","Timestamp (Hour Ending)","Demand (MWh)","Demand Forecast (MWh)","Net Generation (MWh)","Total Interchange (MWh)"
SOCO,"2/1/2024 12 a.m. CST",27321,26828,27687,366
SOCO,"2/1/2024 1 a.m. CST",27801,26895,27899,98
SOCO,"2/1/2024 2 a.m. CST",28216,27330,28294,78
SOCO,"2/1/2024 3 a.m. CST",28666,27990,28727,61
SOCO,"2/1/2024 4 a.m. CST",29238,29068,29358,120
SOCO,"2/1/2024 5 a.m. CST",31210,31037,31137,-73
SOCO,"2/1/2024 6 a.m. CST",33838,33635,34046,208
SOCO,"2/1/2024 7 a.m. CST",35691,35539,35975,284
SOCO,"2/1/2024 8 a.m. CST",35251,35173,35626,375
SOCO,"2/1/2024 9 a.m. CST",32808,32744,33326,518
SOCO,"2/1/2024 10 a.m. CST",30199,30204,30926,727
SOCO,"2/1/2024 11 a.m. CST",28340,28141,29508,1168
SOCO,"2/1/2024 12 p.m. CST",27490,26732,28405,915
SOCO,"2/1/2024 1 p.m. CST",26347,25565,27344,997
SOCO,"2/1/2024 2 p.m. CST",25794,24837,26746,952
SOCO,"2/1/2024 3 p.m. CST",25340,24276,25646,306
SOCO,"2/1/2024 4 p.m. CST",24468,24098,24843,375
SOCO,"2/1/2024 5 p.m. CST",24876,24771,25165,289
SOCO,"2/1/2024 6 p.m. CST",26638,26499,26995,357
SOCO,"2/1/2024 7 p.m. CST",27743,27588,28004,261
SOCO,"2/1/2024 8 p.m. CST",27902,27730,28167,265
SOCO,"2/1/2024 9 p.m. CST",27592,27417,27869,277
SOCO,"2/1/2024 10 p.m. CST",26732,26595,26898,166
SOCO,"2/1/2024 11 p.m. CST",26015,25810,25937,-78
SOCO,"2/2/2024 12 a.m. CST",25132,25026,25124,-8
SOCO,"2/2/2024 1 a.m. CST",24935,24529,24992,57
SOCO,"2/2/2024 2 a.m. CST",24628,24589,24717,89
SOCO,"2/2/2024 3 a.m. CST",24846,24821,25122,276
SOCO,"2/2/2024 4 a.m. CST",25478,25491,25812,334
SOCO,"2/2/2024 5 a.m. CST",26966,26981,27541,575
SOCO,"2/2/2024 6 a.m. CST",29220,29226,29541,321
SOCO,"2/2/2024 7 a.m. CST",30991,30990,31181,190
SOCO,"2/2/2024 8 a.m. CST",30874,30852,31469,595
SOCO,"2/2/2024 9 a.m. CST",29255,29193,30045,790
SOCO,"2/2/2024 10 a.m. CST",27383,27405,27754,371
SOCO,"2/2/2024 11 a.m. CST",25953,25803,26379,426
SOCO,"2/2/2024 12 p.m. CST",25379,24646,25779,400
SOCO,"2/2/2024 1 p.m. CST",24621,23902,25338,717
SOCO,"2/2/2024 2 p.m. CST",24152,23316,25092,940
SOCO,"2/2/2024 3 p.m. CST",23972,22919,24948,976
SOCO,"2/2/2024 4 p.m. CST",23462,22843,24574,1112
SOCO,"2/2/2024 5 p.m. CST",23013,23048,23980,967
SOCO,"2/2/2024 6 p.m. CST",23921,23946,24920,999
SOCO,"2/2/2024 7 p.m. CST",24398,24393,25439,1041
SOCO,"2/2/2024 8 p.m. CST",24404,24326,25270,866
SOCO,"2/2/2024 9 p.m. CST",24200,24143,24733,533
SOCO,"2/2/2024 10 p.m. CST",23741,23689,24230,489
SOCO,"2/2/2024 11 p.m. CST",23090,23051,23757,667
SOCO,"2/3/2024 12 a.m. CST",22964,22572,23627,663
SOCO,"2/3/2024 1 a.m. CST",22739,22360,23530,791
SOCO,"2/3/2024 2 a.m. CST",22652,22277,23469,817
SOCO,"2/3/2024 3 a.m. CST",22855,22490,23675,820
SOCO,"2/3/2024 4 a.m. CST",23394,22991,24298,904
SOCO,"2/3/2024 5 a.m. CST",23728,23742,24647,919
SOCO,"2/3/2024 6 a.m. CST",24737,24737,25744,1007
SOCO,"2/3/2024 7 a.m. CST",25843,25844,26983,1140
SOCO,"2/3/2024 8 a.m. CST",26676,26680,27820,1144
SOCO,"2/3/2024 9 a.m. CST",26390,26399,27203,813
SOCO,"2/3/2024 10 a.m. CST",25434,25515,26211,777
SOCO,"2/3/2024 11 a.m. CST",24459,24456,25056,597
SOCO,"2/3/2024 12 p.m. CST",23854,23498,24608,754
SOCO,"2/3/2024 1 p.m. CST",23368,22699,24356,988
SOCO,"2/3/2024 2 p.m. CST",23355,22233,24490,1135
SOCO,"2/3/2024 3 p.m. CST",23082,21946,24001,919
SOCO,"2/3/2024 4 p.m. CST",22479,21930,23087,608
SOCO,"2/3/2024 5 p.m. CST",23013,22475,23641,628
SOCO,"2/3/2024 6 p.m. CST",24039,23788,24595,556
SOCO,"2/3/2024 7 p.m. CST",24284,24178,24861,577
SOCO,"2/3/2024 8 p.m. CST",24160,24097,24468,308
SOCO,"2/3/2024 9 p.m. CST",23673,23699,24260,587
SOCO,"2/3/2024 10 p.m. CST",23191,23139,23762,571
SOCO,"2/3/2024 11 p.m. CST",22781,22415,23322,541
SOCO,"2/4/2024 12 a.m. CST",22096,21683,22688,592
SOCO,"2/4/2024 1 a.m. CST",22246,21325,23242,996
SOCO,"2/4/2024 2 a.m. CST",21967,21091,23159,1192
SOCO,"2/4/2024 3 a.m. CST",21682,21016,22857,1175
SOCO,"2/4/2024 4 a.m. CST",21415,21265,22319,904
SOCO,"2/4/2024 5 a.m. CST",21864,21720,23032,1168
SOCO,"2/4/2024 6 a.m. CST",22686,22558,23762,1076
SOCO,"2/4/2024 7 a.m. CST",23774,23611,24673,899
SOCO,"2/4/2024 8 a.m. CST",24874,24744,25499,625
SOCO,"2/4/2024 9 a.m. CST",26141,26002,26597,456
SOCO,"2/4/2024 10 a.m. CST",26759,26564,26984,225
SOCO,"2/4/2024 11 a.m. CST",26921,26745,26902,-19
SOCO,"2/4/2024 12 p.m. CST",27310,26922,27302,-8
SOCO,"2/4/2024 1 p.m. CST",27544,27167,27248,-296
SOCO,"2/4/2024 2 p.m. CST",27902,27203,27578,-324
SOCO,"2/4/2024 3 p.m. CST",28031,27281,27613,-418
SOCO,"2/4/2024 4 p.m. CST",27747,27654,27397,-350
SOCO,"2/4/2024 5 p.m. CST",28306,28303,28488,182
SOCO,"2/4/2024 6 p.m. CST",29246,29269,29381,135
SOCO,"2/4/2024 7 p.m. CST",29241,29382,29234,-7
SOCO,"2/4/2024 8 p.m. CST",28751,28860,28640,-111
SOCO,"2/4/2024 9 p.m. CST",27830,27944,27807,-23
SOCO,"2/4/2024 10 p.m. CST",26663,26718,26620,-43
SOCO,"2/4/2024 11 p.m. CST",25861,25629,25994,133
SOCO,"2/5/2024 12 a.m. CST",25219,24683,25442,223
SOCO,"2/5/2024 1 a.m. CST",24762,24042,24832,70
SOCO,"2/5/2024 2 a.m. CST",24435,23737,24580,145
SOCO,"2/5/2024 3 a.m. CST",24555,23831,24718,163
SOCO,"2/5/2024 4 a.m. CST",24560,24441,24845,285
SOCO,"2/5/2024 5 a.m. CST",25682,25842,26044,362
SOCO,"2/5/2024 6 a.m. CST",28012,28094,28569,557
SOCO,"2/5/2024 7 a.m. CST",29667,29761,30005,338
SOCO,"2/5/2024 8 a.m. CST",29705,29906,29759,54
SOCO,"2/5/2024 9 a.m. CST",29806,30068,30005,199
SOCO,"2/5/2024 10 a.m. CST",29852,29925,29926,74
SOCO,"2/5/2024 11 a.m. CST",29379,29397,29252,-127
SOCO,"2/5/2024 12 p.m. CST",29012,28705,28892,-120
SOCO,"2/5/2024 1 p.m. CST",28756,28022,28590,-166
SOCO,"2/5/2024 2 p.m. CST",27973,27253,27808,-165
SOCO,"2/5/2024 3 p.m. CST",27464,26737,27374,-90
SOCO,"2/5/2024 4 p.m. CST",27337,26643,27394,57
SOCO,"2/5/2024 5 p.m. CST",27415,27053,27613,198
SOCO,"2/5/2024 6 p.m. CST",28440,28486,28394,-46
SOCO,"2/5/2024 7 p.m. CST",29257,29288,28868,-389
SOCO,"2/5/2024 8 p.m. CST",29145,29182,28633,-512
SOCO,"2/5/2024 9 p.m. CST",28504,28525,28240,-264
SOCO,"2/5/2024 10 p.m. CST",27435,27476,27330,-105
SOCO,"2/5/2024 11 p.m. CST",26248,26248,26215,-33
SOCO,"2/6/2024 12 a.m. CST",26089,25535,26163,74
SOCO,"2/6/2024 1 a.m. CST",26200,25421,26141,-59
SOCO,"2/6/2024 2 a.m. CST",26160,25472,26087,-73
SOCO,"2/6/2024 3 a.m. CST",26267,25811,26215,-52
SOCO,"2/6/2024 4 a.m. CST",26850,26759,26908,58
SOCO,"2/6/2024 5 a.m. CST",28600,28577,28498,-102
SOCO,"2/6/2024 6 a.m. CST",31157,31249,31005,-152
SOCO,"2/6/2024 7 a.m. CST",32913,33059,32991,78
SOCO,"2/6/2024 8 a.m. CST",32400,32394,32634,234
SOCO,"2/6/2024 9 a.m. CST",30652,30605,30966,314
SOCO,"2/6/2024 10 a.m. CST",28744,28720,29228,484
SOCO,"2/6/2024 11 a.m. CST",27593,27237,28227,634
SOCO,"2/6/2024 12 p.m. CST",26955,26167,27600,645
SOCO,"2/6/2024 1 p.m. CST",26068,25306,26647,579
SOCO,"2/6/2024 2 p.m. CST",25318,24549,26017,699
SOCO,"2/6/2024 3 p.m. CST",25227,24114,25934,707
SOCO,"2/6/2024 4 p.m. CST",25119,24148,25995,876
SOCO,"2/6/2024 5 p.m. CST",25170,24758,26099,929
SOCO,"2/6/2024 6 p.m. CST",26288,26113,26531,243
SOCO,"2/6/2024 7 p.m. CST",27445,27276,27431,-14
SOCO,"2/6/2024 8 p.m. CST",27612,27510,27585,-27
SOCO,"2/6/2024 9 p.m. CST",27414,27213,27557,143
SOCO,"2/6/2024 10 p.m. CST",26556,26380,26725,169
SOCO,"2/6/2024 11 p.m. CST",25701,25523,25854,153
SOCO,"2/7/2024 12 a.m. CST",25346,25179,25483,137
SOCO,"2/7/2024 1 a.m. CST",25705,25196,25554,-151
SOCO,"2/7/2024 2 a.m. CST",26012,25515,25899,-113
SOCO,"2/7/2024 3 a.m. CST",26341,26087,26361,20
SOCO,"2/7/2024 4 a.m. CST",27334,27152,27280,-54
SOCO,"2/7/2024 5 a.m. CST",29212,29027,29070,-142
SOCO,"2/7/2024 6 a.m. CST",32045,31902,31847,-198
SOCO,"2/7/2024 7 a.m. CST",33878,33778,33561,-317
SOCO,"2/7/2024 8 a.m. CST",33249,33064,32937,-312
SOCO,"2/7/2024 9 a.m. CST",31298,31016,30802,-496
SOCO,"2/7/2024 10 a.m. CST",29189,28972,28966,-223
SOCO,"2/7/2024 11 a.m. CST",28310,27527,28075,-235
SOCO,"2/7/2024 12 p.m. CST",27133,26233,27340,207
SOCO,"2/7/2024 1 p.m. CST",26152,25261,26504,352
SOCO,"2/7/2024 2 p.m. CST",25368,24505,25761,393
SOCO,"2/7/2024 3 p.m. CST",25013,24146,25361,348
SOCO,"2/7/2024 4 p.m. CST",24826,24048,25440,614
SOCO,"2/7/2024 5 p.m. CST",24906,24715,25407,501
SOCO,"2/7/2024 6 p.m. CST",26567,26488,26696,129
SOCO,"2/7/2024 7 p.m. CST",27844,27679,27431,-413
SOCO,"2/7/2024 8 p.m. CST",28159,28015,27851,-308
SOCO,"2/7/2024 9 p.m. CST",27972,27733,27826,-146
SOCO,"2/7/2024 10 p.m. CST",27100,26908,27029,-71
SOCO,"2/7/2024 11 p.m. CST",26086,25912,26160,74
SOCO,"2/8/2024 12 a.m. CST",25746,25362,25923,177
SOCO,"2/8/2024 1 a.m. CST",25877,25135,26001,124
SOCO,"2/8/2024 2 a.m. CST",26332,25207,26412,80
SOCO,"2/8/2024 3 a.m. CST",26671,25616,26658,-13
SOCO,"2/8/2024 4 a.m. CST",27151,26592,27166,15
SOCO,"2/8/2024 5 a.m. CST",28669,28443,28394,-275
SOCO,"2/8/2024 6 a.m. CST",31433,31243,31132,-301
SOCO,"2/8/2024 7 a.m. CST",33247,33091,32941,-306
SOCO,"2/8/2024 8 a.m. CST",32539,32459,32604,65
SOCO,"2/8/2024 9 a.m. CST",30775,30616,30810,35
SOCO,"2/8/2024 10 a.m. CST",28906,28846,29557,651
SOCO,"2/8/2024 11 a.m. CST",27566,27362,28044,478
SOCO,"2/8/2024 12 p.m. CST",27201,26451,27471,270
SOCO,"2/8/2024 1 p.m. CST",26702,25669,26883,181
SOCO,"2/8/2024 2 p.m. CST",26124,25145,26489,365
SOCO,"2/8/2024 3 p.m. CST",26139,24755,26515,376
SOCO,"2/8/2024 4 p.m. CST",26073,24871,26698,625
SOCO,"2/8/2024 5 p.m. CST",26107,25428,26968,861
SOCO,"2/8/2024 6 p.m. CST",27149,26843,27946,797
SOCO,"2/8/2024 7 p.m. CST",27725,27418,28295,570
SOCO,"2/8/2024 8 p.m. CST",27646,27316,27979,333
SOCO,"2/8/2024 9 p.m. CST",27036,26696,27188,152
SOCO,"2/8/2024 10 p.m. CST",25783,25453,25995,212
SOCO,"2/8/2024 11 p.m. CST",24483,24176,24475,-8
SOCO,"2/9/2024 12 a.m. CST",23666,23258,23827,161
SOCO,"2/9/2024 1 a.m. CST",23240,22678,23489,249
SOCO,"2/9/2024 2 a.m. CST",22991,22400,23246,255
SOCO,"2/9/2024 3 a.m. CST",23001,22398,23344,343
SOCO,"2/9/2024 4 a.m. CST",23404,22783,23787,383
SOCO,"2/9/2024 5 a.m. CST",24244,24020,24866,622
SOCO,"2/9/2024 6 a.m. CST",26050,25978,26321,271
SOCO,"2/9/2024 7 a.m. CST",27583,27480,27904,321
SOCO,"2/9/2024 8 a.m. CST",27527,27373,27975,448
SOCO,"2/9/2024 9 a.m. CST",26987,26880,27709,722
SOCO,"2/9/2024 10 a.m. CST",26283,26093,27065,782
SOCO,"2/9/2024 11 a.m. CST",25470,25349,26216,746
SOCO,"2/9/2024 12 p.m. CST",25176,24690,25934,758
SOCO,"2/9/2024 1 p.m. CST",25033,24370,25523,490
SOCO,"2/9/2024 2 p.m. CST",24840,24011,25393,553
SOCO,"2/9/2024 3 p.m. CST",24507,23694,25037,530
SOCO,"2/9/2024 4 p.m. CST",24075,23564,24487,412
SOCO,"2/9/2024 5 p.m. CST",23878,23725,24549,671
SOCO,"2/9/2024 6 p.m. CST",24679,24496,25299,620
SOCO,"2/9/2024 7 p.m. CST",24823,24638,25471,648
SOCO,"2/9/2024 8 p.m. CST",24423,24241,25061,638
SOCO,"2/9/2024 9 p.m. CST",23878,23739,24569,691
SOCO,"2/9/2024 10 p.m. CST",23026,22901,23641,615
SOCO,"2/9/2024 11 p.m. CST",21989,21856,22441,452
SOCO,"2/10/2024 12 a.m. CST",21297,20828,21680,383
SOCO,"2/10/2024 1 a.m. CST",20561,20080,20923,362
SOCO,"2/10/2024 2 a.m. CST",20027,19535,20505,478
SOCO,"2/10/2024 3 a.m. CST",19780,19301,20240,460
SOCO,"2/10/2024 4 a.m. CST",19835,19385,20374,539
SOCO,"2/10/2024 5 a.m. CST",19849,19694,20403,554
SOCO,"2/10/2024 6 a.m. CST",20524,20377,21055,531
SOCO,"2/10/2024 7 a.m. CST",21316,21170,22199,883
SOCO,"2/10/2024 8 a.m. CST",22122,21963,22950,828
SOCO,"2/10/2024 9 a.m. CST",22699,22565,23467,768
SOCO,"2/10/2024 10 a.m. CST",22844,22678,23545,701
SOCO,"2/10/2024 11 a.m. CST",22712,22547,23310,598
SOCO,"2/10/2024 12 p.m. CST",22481,22335,23206,725
SOCO,"2/10/2024 1 p.m. CST",22252,22122,22934,682
SOCO,"2/10/2024 2 p.m. CST",22060,21914,22744,684
SOCO,"2/10/2024 3 p.m. CST",21897,21741,22579,682
SOCO,"2/10/2024 4 p.m. CST",21940,21766,22721,781
SOCO,"2/10/2024 5 p.m. CST",22214,22041,23129,915
SOCO,"2/10/2024 6 p.m. CST",22958,22854,23990,1032
SOCO,"2/10/2024 7 p.m. CST",23100,22964,24253,1153
SOCO,"2/10/2024 8 p.m. CST",22688,22550,23503,815
SOCO,"2/10/2024 9 p.m. CST",22193,22067,22985,792
SOCO,"2/10/2024 10 p.m. CST",21341,21206,22125,784
SOCO,"2/10/2024 11 p.m. CST",20361,20218,20822,461
SOCO,"2/11/2024 12 a.m. CST",19402,19257,19861,459
SOCO,"2/11/2024 1 a.m. CST",19075,18575,19709,634
SOCO,"2/11/2024 2 a.m. CST",18774,18171,19440,666
SOCO,"2/11/2024 3 a.m. CST",18589,17970,19203,614
SOCO,"2/11/2024 4 a.m. CST",18512,17904,19092,580
SOCO,"2/11/2024 5 a.m. CST",18694,18049,19396,702
SOCO,"2/11/2024 6 a.m. CST",19090,18453,19578,488
SOCO,"2/11/2024 7 a.m. CST",19809,19174,20463,654
SOCO,"2/11/2024 8 a.m. CST",20615,20156,21263,648
SOCO,"2/11/2024 9 a.m. CST",21387,21192,22121,734
SOCO,"2/11/2024 10 a.m. CST",21945,21772,22747,802
SOCO,"2/11/2024 11 a.m. CST",22108,21957,22920,812
SOCO,"2/11/2024 12 p.m. CST",22132,22026,22925,793
SOCO,"2/11/2024 1 p.m. CST",22263,22113,23217,954
SOCO,"2/11/2024 2 p.m. CST",22401,22220,23359,958
SOCO,"2/11/2024 3 p.m. CST",22430,22257,23347,917
SOCO,"2/11/2024 4 p.m. CST",22681,22542,23629,948
SOCO,"2/11/2024 5 p.m. CST",23252,23112,24195,943
SOCO,"2/11/2024 6 p.m. CST",23800,23679,24880,1080
SOCO,"2/11/2024 7 p.m. CST",23424,23296,24449,1025
SOCO,"2/11/2024 8 p.m. CST",22848,22714,23692,844
SOCO,"2/11/2024 9 p.m. CST",22423,22284,23207,784
SOCO,"2/11/2024 10 p.m. CST",21507,21346,22368,861
SOCO,"2/11/2024 11 p.m. CST",21193,20788,21756,563
SOCO,"2/12/2024 12 a.m. CST",20175,19610,20704,529
SOCO,"2/12/2024 1 a.m. CST",19709,18797,20195,486
SOCO,"2/12/2024 2 a.m. CST",19415,18326,19873,458
SOCO,"2/12/2024 3 a.m. CST",19495,18238,19868,373
SOCO,"2/12/2024 4 a.m. CST",19785,18519,20139,354
SOCO,"2/12/2024 5 a.m. CST",20337,19517,20668,331
SOCO,"2/12/2024 6 a.m. CST",21458,21242,21450,-8
SOCO,"2/12/2024 7 a.m. CST",23047,22951,23351,304
SOCO,"2/12/2024 8 a.m. CST",23557,23511,24055,498
SOCO,"2/12/2024 9 a.m. CST",24167,23997,24734,567
SOCO,"2/12/2024 10 a.m. CST",24720,24555,25646,926
SOCO,"2/12/2024 11 a.m. CST",25052,24858,25997,945
SOCO,"2/12/2024 12 p.m. CST",25161,24966,26286,1125
SOCO,"2/12/2024 1 p.m. CST",25133,24991,26436,1303
SOCO,"2/12/2024 2 p.m. CST",24825,24683,25964,1139
SOCO,"2/12/2024 3 p.m. CST",24581,24465,25627,1046
SOCO,"2/12/2024 4 p.m. CST",24682,24514,25799,1117
SOCO,"2/12/2024 5 p.m. CST",25242,25069,26421,1179
SOCO,"2/12/2024 6 p.m. CST",26075,26028,27155,1080
SOCO,"2/12/2024 7 p.m. CST",26527,26470,27510,983
SOCO,"2/12/2024 8 p.m. CST",26229,26086,27037,808
SOCO,"2/12/2024 9 p.m. CST",25497,25372,26393,896
SOCO,"2/12/2024 10 p.m. CST",24428,24255,25398,970
SOCO,"2/12/2024 11 p.m. CST",23620,23195,24399,779
SOCO,"2/13/2024 12 a.m. CST",23008,22487,23491,483
SOCO,"2/13/2024 1 a.m. CST",22590,22087,22943,353
SOCO,"2/13/2024 2 a.m. CST",22776,22047,23052,276
SOCO,"2/13/2024 3 a.m. CST",23185,22302,23467,282
SOCO,"2/13/2024 4 a.m. CST",23722,22969,23822,100
SOCO,"2/13/2024 5 a.m. CST",24683,24491,24874,191
SOCO,"2/13/2024 6 a.m. CST",27015,26910,27514,499
SOCO,"2/13/2024 7 a.m. CST",28884,28857,29556,672
SOCO,"2/13/2024 8 a.m. CST",29208,29115,29919,711
SOCO,"2/13/2024 9 a.m. CST",28799,28660,29788,989
SOCO,"2/13/2024 10 a.m. CST",28372,27846,29221,849
SOCO,"2/13/2024 11 a.m. CST",27458,26826,28157,699
SOCO,"2/13/2024 12 p.m. CST",26615,25939,27331,716
SOCO,"2/13/2024 1 p.m. CST",26146,25139,26906,760
SOCO,"2/13/2024 2 p.m. CST",25581,24601,26436,855
SOCO,"2/13/2024 3 p.m. CST",24778,24178,25713,935
SOCO,"2/13/2024 4 p.m. CST",24715,24178,25718,1003
SOCO,"2/13/2024 5 p.m. CST",24888,24672,25835,947
SOCO,"2/13/2024 6 p.m. CST",26455,26352,27557,1102
SOCO,"2/13/2024 7 p.m. CST",27907,27779,28907,1000
SOCO,"2/13/2024 8 p.m. CST",28372,28243,29314,942
SOCO,"2/13/2024 9 p.m. CST",28165,27991,29081,916
SOCO,"2/13/2024 10 p.m. CST",27476,27192,28336,860
SOCO,"2/13/2024 11 p.m. CST",26633,26320,27046,413
SOCO,"2/14/2024 12 a.m. CST",26361,25684,26704,343
SOCO,"2/14/2024 1 a.m. CST",26273,25600,26195,-78
SOCO,"2/14/2024 2 a.m. CST",26830,25858,26732,-98
SOCO,"2/14/2024 3 a.m. CST",27347,26247,27194,-153
SOCO,"2/14/2024 4 a.m. CST",27957,27245,27853,-104
SOCO,"2/14/2024 5 a.m. CST",29247,29040,28975,-272
SOCO,"2/14/2024 6 a.m. CST",31979,31778,32285,306
SOCO,"2/14/2024 7 a.m. CST",33707,33516,33680,-27
SOCO,"2/14/2024 8 a.m. CST",32986,32808,32871,-115
SOCO,"2/14/2024 9 a.m. CST",30743,30555,30978,235
SOCO,"2/14/2024 10 a.m. CST",28662,28371,28944,282
SOCO,"2/14/2024 11 a.m. CST",26926,26604,27263,337
SOCO,"2/14/2024 12 p.m. CST",26285,25301,26577,292
SOCO,"2/14/2024 1 p.m. CST",25554,24535,25857,303
SOCO,"2/14/2024 2 p.m. CST",25207,23895,25599,392
SOCO,"2/14/2024 3 p.m. CST",24474,23465,24878,404
SOCO,"2/14/2024 4 p.m. CST",24045,23421,24644,599
SOCO,"2/14/2024 5 p.m. CST",24063,23791,24558,495
SOCO,"2/14/2024 6 p.m. CST",25094,24902,25440,346
SOCO,"2/14/2024 7 p.m. CST",26215,26039,26499,284
SOCO,"2/14/2024 8 p.m. CST",26310,26120,26482,172
SOCO,"2/14/2024 9 p.m. CST",26139,25954,26169,30
SOCO,"2/14/2024 10 p.m. CST",25467,25259,25645,178
SOCO,"2/14/2024 11 p.m. CST",24820,24499,24646,-174
SOCO,"2/15/2024 12 a.m. CST",24499,24019,24531,32
SOCO,"2/15/2024 1 a.m. CST",24482,23823,24617,135
SOCO,"2/15/2024 2 a.m. CST",24503,23827,24549,46
SOCO,"2/15/2024 3 a.m. CST",24870,24192,24913,43
SOCO,"2/15/2024 4 a.m. CST",25315,24964,25571,256
SOCO,"2/15/2024 5 a.m. CST",26692,26511,26725,33
SOCO,"2/15/2024 6 a.m. CST",29153,29021,29069,-84
SOCO,"2/15/2024 7 a.m. CST",30960,30848,31211,251
SOCO,"2/15/2024 8 a.m. CST",30648,30251,30983,335
SOCO,"2/15/2024 9 a.m. CST",28578,28458,29237,659
SOCO,"2/15/2024 10 a.m. CST",26977,26752,27862,885
SOCO,"2/15/2024 11 a.m. CST",26177,25538,27177,1000
SOCO,"2/15/2024 12 p.m. CST",25167,24578,26358,1191
SOCO,"2/15/2024 1 p.m. CST",25018,24037,26029,1011
SOCO,"2/15/2024 2 p.m. CST",24612,23631,25618,1006
SOCO,"2/15/2024 3 p.m. CST",24298,23323,25459,1161
SOCO,"2/15/2024 4 p.m. CST",23787,23179,25077,1290
SOCO,"2/15/2024 5 p.m. CST",23781,23431,25048,1267
SOCO,"2/15/2024 6 p.m. CST",24742,24545,25697,955
SOCO,"2/15/2024 7 p.m. CST",25483,25305,26231,748
SOCO,"2/15/2024 8 p.m. CST",25408,25204,26147,739
SOCO,"2/15/2024 9 p.m. CST",24971,24771,25740,769
SOCO,"2/15/2024 10 p.m. CST",23996,23663,24718,722
SOCO,"2/15/2024 11 p.m. CST",23072,22782,23505,433
SOCO,"2/16/2024 12 a.m. CST",22182,21936,22764,582
SOCO,"2/16/2024 1 a.m. CST",22134,21458,22741,607
SOCO,"2/16/2024 2 a.m. CST",21982,21322,22592,610
SOCO,"2/16/2024 3 a.m. CST",22017,21382,22751,734
SOCO,"2/16/2024 4 a.m. CST",22358,21719,23254,896
SOCO,"2/16/2024 5 a.m. CST",22977,22858,23891,914
SOCO,"2/16/2024 6 a.m. CST",24872,24744,25532,660
SOCO,"2/16/2024 7 a.m. CST",26341,26275,26986,645
SOCO,"2/16/2024 8 a.m. CST",26556,26543,27012,456
SOCO,"2/16/2024 9 a.m. CST",26112,26072,26691,579
SOCO,"2/16/2024 10 a.m. CST",25443,25259,26137,694
SOCO,"2/16/2024 11 a.m. CST",24670,24531,25333,663
SOCO,"2/16/2024 12 p.m. CST",24418,23947,25055,637
SOCO,"2/16/2024 1 p.m. CST",24243,23653,24999,756
SOCO,"2/16/2024 2 p.m. CST",24375,23397,24934,559
SOCO,"2/16/2024 3 p.m. CST",24033,23180,24661,628
SOCO,"2/16/2024 4 p.m. CST",23758,23124,24508,750
SOCO,"2/16/2024 5 p.m. CST",23979,23375,24779,800
SOCO,"2/16/2024 6 p.m. CST",24443,24145,25050,607
SOCO,"2/16/2024 7 p.m. CST",24783,24562,25181,398
SOCO,"2/16/2024 8 p.m. CST",24438,24131,25096,658
SOCO,"2/16/2024 9 p.m. CST",23938,23663,24641,703
SOCO,"2/16/2024 10 p.m. CST",23086,22787,23495,409
SOCO,"2/16/2024 11 p.m. CST",22089,21803,22537,448
SOCO,"2/17/2024 12 a.m. CST",21508,20842,21952,444
SOCO,"2/17/2024 1 a.m. CST",20798,20166,21874,1076
SOCO,"2/17/2024 2 a.m. CST",20700,19783,21987,1287
SOCO,"2/17/2024 3 a.m. CST",20124,19603,21491,1367
SOCO,"2/17/2024 4 a.m. CST",20147,19778,21632,1485
SOCO,"2/17/2024 5 a.m. CST",20647,20489,21963,1316
SOCO,"2/17/2024 6 a.m. CST",21678,21522,22923,1245
SOCO,"2/17/2024 7 a.m. CST",22911,22752,24052,1141
SOCO,"2/17/2024 8 a.m. CST",24385,24202,25324,939
SOCO,"2/17/2024 9 a.m. CST",25639,25463,26712,1073
SOCO,"2/17/2024 10 a.m. CST",26268,26051,27261,993
SOCO,"2/17/2024 11 a.m. CST",26263,26053,27100,837
SOCO,"2/17/2024 12 p.m. CST",25898,25676,26674,776
SOCO,"2/17/2024 1 p.m. CST",25831,25252,26528,697
SOCO,"2/17/2024 2 p.m. CST",25913,24953,26447,534
SOCO,"2/17/2024 3 p.m. CST",25996,24984,26543,547
SOCO,"2/17/2024 4 p.m. CST",26037,25443,26712,675
SOCO,"2/17/2024 5 p.m. CST",26508,26271,27220,712
SOCO,"2/17/2024 6 p.m. CST",27936,27681,28734,798
SOCO,"2/17/2024 7 p.m. CST",28735,28560,29667,932
SOCO,"2/17/2024 8 p.m. CST",28834,28549,29694,860
SOCO,"2/17/2024 9 p.m. CST",28523,28252,29389,866
SOCO,"2/17/2024 10 p.m. CST",27884,27630,28728,844
SOCO,"2/17/2024 11 p.m. CST",27144,26904,28178,1034
SOCO,"2/18/2024 12 a.m. CST",26509,26270,27560,1051
SOCO,"2/18/2024 1 a.m. CST",26369,25928,27127,758
SOCO,"2/18/2024 2 a.m. CST",26341,25817,27242,901
SOCO,"2/18/2024 3 a.m. CST",26403,25859,27197,794
SOCO,"2/18/2024 4 a.m. CST",26730,26222,27233,503
SOCO,"2/18/2024 5 a.m. CST",27044,26831,27223,179
SOCO,"2/18/2024 6 a.m. CST",27959,27730,28264,305
SOCO,"2/18/2024 7 a.m. CST",29253,28975,29693,440
SOCO,"2/18/2024 8 a.m. CST",30579,30299,31002,423
SOCO,"2/18/2024 9 a.m. CST",31134,30855,31979,845
SOCO,"2/18/2024 10 a.m. CST",30538,30322,31634,1096
SOCO,"2/18/2024 11 a.m. CST",29241,29045,30270,1029
SOCO,"2/18/2024 12 p.m. CST",28389,27855,29261,872
SOCO,"2/18/2024 1 p.m. CST",27421,26611,27724,303
SOCO,"2/18/2024 2 p.m. CST",26673,25461,27123,450
SOCO,"2/18/2024 3 p.m. CST",25833,24784,26144,311
SOCO,"2/18/2024 4 p.m. CST",25354,24549,25836,482
SOCO,"2/18/2024 5 p.m. CST",25585,25128,26130,545
SOCO,"2/18/2024 6 p.m. CST",26789,26618,27857,1068
SOCO,"2/18/2024 7 p.m. CST",28248,28167,29267,1019
SOCO,"2/18/2024 8 p.m. CST",28595,28471,29592,997
SOCO,"2/18/2024 9 p.m. CST",28461,28283,29293,832
SOCO,"2/18/2024 10 p.m. CST",27961,27790,28761,800
SOCO,"2/18/2024 11 p.m. CST",27247,27087,28154,907
SOCO,"2/19/2024 12 a.m. CST",26950,26611,27906,956
SOCO,"2/19/2024 1 a.m. CST",27135,26638,27865,730
SOCO,"2/19/2024 2 a.m. CST",27482,26976,28105,623
SOCO,"2/19/2024 3 a.m. CST",28015,27506,28687,672
SOCO,"2/19/2024 4 a.m. CST",28689,28408,29289,600
SOCO,"2/19/2024 5 a.m. CST",30153,29907,30695,542
SOCO,"2/19/2024 6 a.m. CST",32252,32054,32874,622
SOCO,"2/19/2024 7 a.m. CST",34101,33970,34721,620
SOCO,"2/19/2024 8 a.m. CST",34145,33987,35010,865
SOCO,"2/19/2024 9 a.m. CST",32488,32320,33568,1080
SOCO,"2/19/2024 10 a.m. CST",30652,30312,31535,883
SOCO,"2/19/2024 11 a.m. CST",28798,28480,29857,1059
SOCO,"2/19/2024 12 p.m. CST",28012,27075,28948,936
SOCO,"2/19/2024 1 p.m. CST",27033,26029,27555,522
SOCO,"2/19/2024 2 p.m. CST",26136,25160,26836,700
SOCO,"2/19/2024 3 p.m. CST",25831,24563,26711,880
SOCO,"2/19/2024 4 p.m. CST",25357,24379,26166,809
SOCO,"2/19/2024 5 p.m. CST",25055,24783,25643,588
SOCO,"2/19/2024 6 p.m. CST",26413,26261,27303,890
SOCO,"2/19/2024 7 p.m. CST",28041,27881,28999,958
SOCO,"2/19/2024 8 p.m. CST",28599,28414,29546,947
SOCO,"2/19/2024 9 p.m. CST",28373,28192,29051,678
SOCO,"2/19/2024 10 p.m. CST",27710,27485,28409,699
SOCO,"2/19/2024 11 p.m. CST",27025,26812,27366,341
SOCO,"2/20/2024 12 a.m. CST",26799,26591,27382,583
SOCO,"2/20/2024 1 a.m. CST",27293,26729,28127,834
SOCO,"2/20/2024 2 a.m. CST",27707,27113,28587,880
SOCO,"2/20/2024 3 a.m. CST",28020,27819,28857,837
SOCO,"2/20/2024 4 a.m. CST",29107,28884,30028,921
SOCO,"2/20/2024 5 a.m. CST",30948,30704,31959,1011
SOCO,"2/20/2024 6 a.m. CST",33510,33305,34076,566
SOCO,"2/20/2024 7 a.m. CST",35369,35228,35913,544
SOCO,"2/20/2024 8 a.m. CST",34479,34291,35469,990
SOCO,"2/20/2024 9 a.m. CST",31904,31775,32965,1061
SOCO,"2/20/2024 10 a.m. CST",29621,29448,30564,943
SOCO,"2/20/2024 11 a.m. CST",28150,27500,28721,571
SOCO,"2/20/2024 12 p.m. CST",27217,26272,27771,554
SOCO,"2/20/2024 1 p.m. CST",26356,25355,26802,446
SOCO,"2/20/2024 2 p.m. CST",25736,24564,26293,557
SOCO,"2/20/2024 3 p.m. CST",25157,24052,25677,520
SOCO,"2/20/2024 4 p.m. CST",24861,23974,25299,438
SOCO,"2/20/2024 5 p.m. CST",24341,24233,25316,975
SOCO,"2/20/2024 6 p.m. CST",25760,25582,26519,759
SOCO,"2/20/2024 7 p.m. CST",27178,26995,27777,599
SOCO,"2/20/2024 8 p.m. CST",27465,27264,28038,573
SOCO,"2/20/2024 9 p.m. CST",27165,27020,27551,386
SOCO,"2/20/2024 10 p.m. CST",26599,26345,26684,85
SOCO,"2/20/2024 11 p.m. CST",25816,25565,25730,-86
SOCO,"2/21/2024 12 a.m. CST",25705,25112,25612,-93
SOCO,"2/21/2024 1 a.m. CST",25743,25141,26002,259
SOCO,"2/21/2024 2 a.m. CST",26057,25441,26592,535
SOCO,"2/21/2024 3 a.m. CST",26226,25987,26633,407
SOCO,"2/21/2024 4 a.m. CST",27391,27135,27704,313
SOCO,"2/21/2024 5 a.m. CST",29033,28927,29368,335
SOCO,"2/21/2024 6 a.m. CST",31708,31563,31937,229
SOCO,"2/21/2024 7 a.m. CST",33524,33427,33981,457
SOCO,"2/21/2024 8 a.m. CST",32651,32616,33398,747
SOCO,"2/21/2024 9 a.m. CST",30060,30027,30616,556
SOCO,"2/21/2024 10 a.m. CST",27899,27708,28459,560
SOCO,"2/21/2024 11 a.m. CST",26966,25845,27454,488
SOCO,"2/21/2024 12 p.m. CST",26080,24924,26527,447
SOCO,"2/21/2024 1 p.m. CST",25707,24342,26408,701
SOCO,"2/21/2024 2 p.m. CST",25175,23772,25895,720
SOCO,"2/21/2024 3 p.m. CST",24428,23485,25239,811
SOCO,"2/21/2024 4 p.m. CST",23864,23369,24842,978
SOCO,"2/21/2024 5 p.m. CST",23969,23692,25086,1117
SOCO,"2/21/2024 6 p.m. CST",24857,24428,25670,813
SOCO,"2/21/2024 7 p.m. CST",26016,25807,26626,610
SOCO,"2/21/2024 8 p.m. CST",26038,25831,26549,511
SOCO,"2/21/2024 9 p.m. CST",25702,25422,26123,421
SOCO,"2/21/2024 10 p.m. CST",24782,24493,25515,733
SOCO,"2/21/2024 11 p.m. CST",23775,23519,24239,464
SOCO,"2/22/2024 12 a.m. CST",23090,22805,23724,634
SOCO,"2/22/2024 1 a.m. CST",22903,22544,23472,569
SOCO,"2/22/2024 2 a.m. CST",23229,22658,23922,693
SOCO,"2/22/2024 3 a.m. CST",23131,22918,23691,560
SOCO,"2/22/2024 4 a.m. CST",23899,23693,24347,448
SOCO,"2/22/2024 5 a.m. CST",25464,25297,26027,563
SOCO,"2/22/2024 6 a.m. CST",27857,27684,28078,221
SOCO,"2/22/2024 7 a.m. CST",29552,29331,29706,154
SOCO,"2/22/2024 8 a.m. CST",28877,28764,29228,351
SOCO,"2/22/2024 9 a.m. CST",27462,27366,28083,621
SOCO,"2/22/2024 10 a.m. CST",26521,26005,27099,578
SOCO,"2/22/2024 11 a.m. CST",26036,25042,26561,525
SOCO,"2/22/2024 12 p.m. CST",25230,24243,25504,274
SOCO,"2/22/2024 1 p.m. CST",24592,23707,24975,383
SOCO,"2/22/2024 2 p.m. CST",24293,23412,24693,400
SOCO,"2/22/2024 3 p.m. CST",24004,23174,24453,449
SOCO,"2/22/2024 4 p.m. CST",23607,23207,24060,453
SOCO,"2/22/2024 5 p.m. CST",23639,23434,24148,509
SOCO,"2/22/2024 6 p.m. CST",24413,24288,24881,468
SOCO,"2/22/2024 7 p.m. CST",25139,25045,25361,222
SOCO,"2/22/2024 8 p.m. CST",24850,24722,25030,180
SOCO,"2/22/2024 9 p.m. CST",24114,24019,24242,128
SOCO,"2/22/2024 10 p.m. CST",22869,22788,23184,315
SOCO,"2/22/2024 11 p.m. CST",21630,21570,21926,296
SOCO,"2/23/2024 12 a.m. CST",20641,20570,20943,302
SOCO,"2/23/2024 1 a.m. CST",20607,19730,20680,73
SOCO,"2/23/2024 2 a.m. CST",20289,19367,20441,152
SOCO,"2/23/2024 3 a.m. CST",20066,19155,20313,247
SOCO,"2/23/2024 4 a.m. CST",20208,19374,20504,296
SOCO,"2/23/2024 5 a.m. CST",20269,20189,20890,621
SOCO,"2/23/2024 6 a.m. CST",22052,21965,22622,570
SOCO,"2/23/2024 7 a.m. CST",23310,23326,24271,961
SOCO,"2/23/2024 8 a.m. CST",23681,23623,24574,893
SOCO,"2/23/2024 9 a.m. CST",23855,23792,24932,1077
SOCO,"2/23/2024 10 a.m. CST",23967,23899,24995,1028
SOCO,"2/23/2024 11 a.m. CST",23724,23726,24575,851
SOCO,"2/23/2024 12 p.m. CST",23402,23432,24266,864
SOCO,"2/23/2024 1 p.m. CST",23149,23142,24225,1076
SOCO,"2/23/2024 2 p.m. CST",23318,22971,24384,1066
SOCO,"2/23/2024 3 p.m. CST",23134,22801,23977,843
SOCO,"2/23/2024 4 p.m. CST",22826,22727,23843,1017
SOCO,"2/23/2024 5 p.m. CST",22705,22660,23686,981
SOCO,"2/23/2024 6 p.m. CST",23097,22978,24024,927
SOCO,"2/23/2024 7 p.m. CST",23594,23528,24499,905
SOCO,"2/23/2024 8 p.m. CST",23446,23397,24244,798
SOCO,"2/23/2024 9 p.m. CST",23078,23016,23869,791
SOCO,"2/23/2024 10 p.m. CST",22456,22384,23150,694
SOCO,"2/23/2024 11 p.m. CST",21741,21674,22164,423
SOCO,"2/24/2024 12 a.m. CST",21042,21027,21583,541
SOCO,"2/24/2024 1 a.m. CST",21005,20586,21393,388
SOCO,"2/24/2024 2 a.m. CST",20831,20409,21135,304
SOCO,"2/24/2024 3 a.m. CST",20870,20565,21265,395
SOCO,"2/24/2024 4 a.m. CST",21119,21043,21610,491
SOCO,"2/24/2024 5 a.m. CST",21939,21844,22423,484
SOCO,"2/24/2024 6 a.m. CST",23094,22954,23665,571
SOCO,"2/24/2024 7 a.m. CST",24310,24171,24928,618
SOCO,"2/24/2024 8 a.m. CST",24984,24855,25868,884
SOCO,"2/24/2024 9 a.m. CST",24759,24646,25914,1155
SOCO,"2/24/2024 10 a.m. CST",24016,23903,25507,1491
SOCO,"2/24/2024 11 a.m. CST",23212,23106,24645,1433
SOCO,"2/24/2024 12 p.m. CST",22892,22433,24276,1384
SOCO,"2/24/2024 1 p.m. CST",22817,22011,23970,1153
SOCO,"2/24/2024 2 p.m. CST",22479,21663,23691,1212
SOCO,"2/24/2024 3 p.m. CST",22230,21415,23588,1358
SOCO,"2/24/2024 4 p.m. CST",21824,21371,23294,1470
SOCO,"2/24/2024 5 p.m. CST",21792,21614,23435,1643
SOCO,"2/24/2024 6 p.m. CST",22674,22496,24220,1546
SOCO,"2/24/2024 7 p.m. CST",23573,23403,24995,1422
SOCO,"2/24/2024 8 p.m. CST",23585,23398,24903,1318
SOCO,"2/24/2024 9 p.m. CST",23439,23288,24796,1357
SOCO,"2/24/2024 10 p.m. CST",23063,22963,24502,1439
SOCO,"2/24/2024 11 p.m. CST",22559,22459,23738,1179
SOCO,"2/25/2024 12 a.m. CST",22248,21940,23387,1139
SOCO,"2/25/2024 1 a.m. CST",22148,22103,23207,1059
SOCO,"2/25/2024 2 a.m. CST",22414,22336,23461,1047
SOCO,"2/25/2024 3 a.m. CST",22877,22819,23891,1014
SOCO,"2/25/2024 4 a.m. CST",23666,23603,24688,1022
SOCO,"2/25/2024 5 a.m. CST",24718,24578,25792,1074
SOCO,"2/25/2024 6 a.m. CST",26047,25902,26796,749
SOCO,"2/25/2024 7 a.m. CST",27595,27437,28324,729
SOCO,"2/25/2024 8 a.m. CST",28176,28029,29416,1240
SOCO,"2/25/2024 9 a.m. CST",27081,26962,28404,1323
SOCO,"2/25/2024 10 a.m. CST",25469,25349,26603,1134
SOCO,"2/25/2024 11 a.m. CST",24691,23917,25497,806
SOCO,"2/25/2024 12 p.m. CST",23847,22995,24876,1029
SOCO,"2/25/2024 1 p.m. CST",23136,22274,24185,1049
SOCO,"2/25/2024 2 p.m. CST",22635,21804,23867,1232
SOCO,"2/25/2024 3 p.m. CST",22394,21614,23642,1248
SOCO,"2/25/2024 4 p.m. CST",22386,21725,23802,1416
SOCO,"2/25/2024 5 p.m. CST",22322,22146,24094,1772
SOCO,"2/25/2024 6 p.m. CST",23298,23169,24922,1624
SOCO,"2/25/2024 7 p.m. CST",24587,24511,25826,1239
SOCO,"2/25/2024 8 p.m. CST",24606,24459,25763,1157
SOCO,"2/25/2024 9 p.m. CST",24112,23932,25519,1407
SOCO,"2/25/2024 10 p.m. CST",23200,23079,24557,1357
SOCO,"2/25/2024 11 p.m. CST",22401,22151,23613,1212
SOCO,"2/26/2024 12 a.m. CST",22054,21490,23111,1057
SOCO,"2/26/2024 1 a.m. CST",22017,21260,22716,699
SOCO,"2/26/2024 2 a.m. CST",22292,21335,22766,474
SOCO,"2/26/2024 3 a.m. CST",22262,21682,22666,404
SOCO,"2/26/2024 4 a.m. CST",23051,22590,23438,387
SOCO,"2/26/2024 5 a.m. CST",24451,24373,24822,371
SOCO,"2/26/2024 6 a.m. CST",27134,26985,27584,450
SOCO,"2/26/2024 7 a.m. CST",28890,28860,29398,508
SOCO,"2/26/2024 8 a.m. CST",28197,28167,29082,885
SOCO,"2/26/2024 9 a.m. CST",26603,26460,27415,812
SOCO,"2/26/2024 10 a.m. CST",25349,25272,26189,840
SOCO,"2/26/2024 11 a.m. CST",24833,24409,25622,789
SOCO,"2/26/2024 12 p.m. CST",24302,23828,25101,799
SOCO,"2/26/2024 1 p.m. CST",24445,23583,25070,625
SOCO,"2/26/2024 2 p.m. CST",24365,23475,24967,602
SOCO,"2/26/2024 3 p.m. CST",24130,23228,24730,600
SOCO,"2/26/2024 4 p.m. CST",24221,23377,24931,710
SOCO,"2/26/2024 5 p.m. CST",23654,23535,24630,976
SOCO,"2/26/2024 6 p.m. CST",24377,24272,25443,1066
SOCO,"2/26/2024 7 p.m. CST",25346,25228,26072,726
SOCO,"2/26/2024 8 p.m. CST",25162,24855,25699,537
SOCO,"2/26/2024 9 p.m. CST",24195,23843,24661,466
SOCO,"2/26/2024 10 p.m. CST",22839,22512,23527,688
SOCO,"2/26/2024 11 p.m. CST",21549,21184,21920,371
SOCO,"2/27/2024 12 a.m. CST",21203,20208,21526,323
SOCO,"2/27/2024 1 a.m. CST",20382,19537,21133,751
SOCO,"2/27/2024 2 a.m. CST",20116,19257,20756,640
SOCO,"2/27/2024 3 a.m. CST",19933,19179,20634,701
SOCO,"2/27/2024 4 a.m. CST",19941,19533,20774,833
SOCO,"2/27/2024 5 a.m. CST",20755,20590,21437,682
SOCO,"2/27/2024 6 a.m. CST",22642,22454,22880,238
SOCO,"2/27/2024 7 a.m. CST",23794,23646,24331,537
SOCO,"2/27/2024 8 a.m. CST",23964,23782,25005,1041
SOCO,"2/27/2024 9 a.m. CST",24139,23894,25405,1266
SOCO,"2/27/2024 10 a.m. CST",24193,23950,25337,1144
SOCO,"2/27/2024 11 a.m. CST",24151,23894,25065,914
SOCO,"2/27/2024 12 p.m. CST",24076,23821,25057,981
SOCO,"2/27/2024 1 p.m. CST",24046,23844,25104,1058
SOCO,"2/27/2024 2 p.m. CST",24029,23830,25286,1257
SOCO,"2/27/2024 3 p.m. CST",23902,23681,25067,1165
SOCO,"2/27/2024 4 p.m. CST",23911,23654,25154,1243
SOCO,"2/27/2024 5 p.m. CST",24293,24000,25293,1000
SOCO,"2/27/2024 6 p.m. CST",24843,24800,25797,954
SOCO,"2/27/2024 7 p.m. CST",25517,25465,26278,761
SOCO,"2/27/2024 8 p.m. CST",25199,25031,25853,654
SOCO,"2/27/2024 9 p.m. CST",24337,24150,24958,621
SOCO,"2/27/2024 10 p.m. CST",22847,22706,23403,556
SOCO,"2/27/2024 11 p.m. CST",21812,21314,22202,390
SOCO,"2/28/2024 12 a.m. CST",20624,20143,20858,234
SOCO,"2/28/2024 1 a.m. CST",19863,19374,20110,247
SOCO,"2/28/2024 2 a.m. CST",19392,18950,19620,228
SOCO,"2/28/2024 3 a.m. CST",19347,18691,19646,299
SOCO,"2/28/2024 4 a.m. CST",19747,18940,20075,328
SOCO,"2/28/2024 5 a.m. CST",20286,19834,20455,169
SOCO,"2/28/2024 6 a.m. CST",21746,21625,22072,326
SOCO,"2/28/2024 7 a.m. CST",23010,22940,23718,708
SOCO,"2/28/2024 8 a.m. CST",23272,23123,24083,811
SOCO,"2/28/2024 9 a.m. CST",23615,23454,24687,1072
SOCO,"2/28/2024 10 a.m. CST",24151,23809,25317,1166
SOCO,"2/28/2024 11 a.m. CST",24573,24022,25911,1338
SOCO,"2/28/2024 12 p.m. CST",24530,24175,25650,1120
SOCO,"2/28/2024 1 p.m. CST",24405,24281,25551,1146
SOCO,"2/28/2024 2 p.m. CST",24476,24325,25602,1126
SOCO,"2/28/2024 3 p.m. CST",24246,24104,25433,1187
SOCO,"2/28/2024 4 p.m. CST",24287,24123,25779,1492
SOCO,"2/28/2024 5 p.m. CST",24372,24228,25514,1142
SOCO,"2/28/2024 6 p.m. CST",25070,24908,26251,1181
SOCO,"2/28/2024 7 p.m. CST",25686,25587,26736,1050
SOCO,"2/28/2024 8 p.m. CST",25423,25272,25995,572
SOCO,"2/28/2024 9 p.m. CST",24852,24747,25455,603
SOCO,"2/28/2024 10 p.m. CST",23730,23593,24397,667
SOCO,"2/28/2024 11 p.m. CST",22853,22498,23770,917
SOCO,"2/29/2024 12 a.m. CST",22192,21682,22626,434
SOCO,"2/29/2024 1 a.m. CST",21998,21393,22430,432
SOCO,"2/29/2024 2 a.m. CST",22045,21361,22740,695
SOCO,"2/29/2024 3 a.m. CST",22550,21609,23529,979
SOCO,"2/29/2024 4 a.m. CST",23142,22377,24144,1002
SOCO,"2/29/2024 5 a.m. CST",24003,23880,25033,1030
SOCO,"2/29/2024 6 a.m. CST",26596,26439,27571,975
SOCO,"2/29/2024 7 a.m. CST",28360,28276,29514,1154
SOCO,"2/29/2024 8 a.m. CST",28685,28609,30192,1507
SOCO,"2/29/2024 9 a.m. CST",28247,28151,29609,1362
SOCO,"2/29/2024 10 a.m. CST",27707,27609,28965,1258
SOCO,"2/29/2024 11 a.m. CST",27341,26790,28189,848
SOCO,"2/29/2024 12 p.m. CST",26909,26074,27772,863
SOCO,"2/29/2024 1 p.m. CST",26889,25788,27878,989
SOCO,"2/29/2024 2 p.m. CST",26608,25586,27702,1094
SOCO,"2/29/2024 3 p.m. CST",26290,25423,27359,1069
SOCO,"2/29/2024 4 p.m. CST",25841,25661,26719,878
SOCO,"2/29/2024 5 p.m. CST",26432,26270,27364,932
SOCO,"2/29/2024 6 p.m. CST",27798,27724,29067,1269
SOCO,"2/29/2024 7 p.m. CST",28634,28562,29844,1210
SOCO,"2/29/2024 8 p.m. CST",28299,28214,29338,1039
SOCO,"2/29/2024 9 p.m. CST",27478,27360,28572,1094
SOCO,"2/29/2024 10 p.m. CST",26092,25939,27197,1105
SOCO,"2/29/2024 11 p.m. CST",24985,24632,25949,964
SOCO,"3/1/2024 12 a.m. CST",23729,23448,24364,635
