"BA Code","Timestamp (Hour Ending)","Demand (MWh)","Demand Forecast (MWh)","Net Generation (MWh)","Total Interchange (MWh)"
SOCO,"1/1/2025 12 a.m. CST",21136,20886,21958,822
SOCO,"1/1/2025 1 a.m. CST",21630,20695,22429,799
SOCO,"1/1/2025 2 a.m. CST",21582,20608,22430,848
SOCO,"1/1/2025 3 a.m. CST",21305,20711,22152,847
SOCO,"1/1/2025 4 a.m. CST",21641,21081,22400,759
SOCO,"1/1/2025 5 a.m. CST",22018,21803,22754,736
SOCO,"1/1/2025 6 a.m. CST",22906,22726,23765,859
SOCO,"1/1/2025 7 a.m. CST",23794,23651,24760,966
SOCO,"1/1/2025 8 a.m. CST",24600,24338,25445,845
SOCO,"1/1/2025 9 a.m. CST",24857,24568,25938,1081
SOCO,"1/1/2025 10 a.m. CST",24847,24564,25867,1020
SOCO,"1/1/2025 11 a.m. CST",24617,24300,25415,798
SOCO,"1/1/2025 12 p.m. CST",24423,23753,25113,690
SOCO,"1/1/2025 1 p.m. CST",23698,23040,24577,879
SOCO,"1/1/2025 2 p.m. CST",23185,22549,24356,1171
SOCO,"1/1/2025 3 p.m. CST",22984,22342,24194,1210
SOCO,"1/1/2025 4 p.m. CST",23047,22613,24355,1308
SOCO,"1/1/2025 5 p.m. CST",24027,23811,24857,830
SOCO,"1/1/2025 6 p.m. CST",25664,25443,26508,844
SOCO,"1/1/2025 7 p.m. CST",26202,25958,26987,785
SOCO,"1/1/2025 8 p.m. CST",26543,26301,27390,847
SOCO,"1/1/2025 9 p.m. CST",26481,26261,27437,956
SOCO,"1/1/2025 10 p.m. CST",26144,25932,26946,802
SOCO,"1/1/2025 11 p.m. CST",25638,25421,26550,912
SOCO,"1/2/2025 12 a.m. CST",25835,25228,26611,776
SOCO,"1/2/2025 1 a.m. CST",26591,25357,27314,723
SOCO,"1/2/2025 2 a.m. CST",26952,25644,27762,810
SOCO,"1/2/2025 3 a.m. CST",27290,26347,27902,612
SOCO,"1/2/2025 4 a.m. CST",27860,27370,28306,446
SOCO,"1/2/2025 5 a.m. CST",29208,28991,30192,984
SOCO,"1/2/2025 6 a.m. CST",31518,31286,32577,1059
SOCO,"1/2/2025 7 a.m. CST",33588,33369,34604,1016
SOCO,"1/2/2025 8 a.m. CST",34361,34144,35592,1231
SOCO,"1/2/2025 9 a.m. CST",33302,32952,35070,1768
SOCO,"1/2/2025 10 a.m. CST",31857,31389,33160,1303
SOCO,"1/2/2025 11 a.m. CST",30273,29788,31255,982
SOCO,"1/2/2025 12 p.m. CST",29263,28442,30475,1212
SOCO,"1/2/2025 1 p.m. CST",28462,27215,29262,800
SOCO,"1/2/2025 2 p.m. CST",27577,26329,28615,1038
SOCO,"1/2/2025 3 p.m. CST",27013,25795,28031,1018
SOCO,"1/2/2025 4 p.m. CST",26646,25873,27540,894
SOCO,"1/2/2025 5 p.m. CST",27533,27234,28024,491
SOCO,"1/2/2025 6 p.m. CST",29458,29277,30460,1002
SOCO,"1/2/2025 7 p.m. CST",30150,29956,31134,984
SOCO,"1/2/2025 8 p.m. CST",30749,30509,31404,655
SOCO,"1/2/2025 9 p.m. CST",30612,30400,31334,722
SOCO,"1/2/2025 10 p.m. CST",29932,29656,30495,563
SOCO,"1/2/2025 11 p.m. CST",29359,29090,29838,479
SOCO,"1/3/2025 12 a.m. CST",29412,28763,29994,582
SOCO,"1/3/2025 1 a.m. CST",29238,28604,29836,598
SOCO,"1/3/2025 2 a.m. CST",29209,28587,29775,566
SOCO,"1/3/2025 3 a.m. CST",29536,28904,29916,380
SOCO,"1/3/2025 4 a.m. CST",30141,29525,30110,-31
SOCO,"1/3/2025 5 a.m. CST",31045,30818,31175,130
SOCO,"1/3/2025 6 a.m. CST",32787,32492,32951,164
SOCO,"1/3/2025 7 a.m. CST",34313,34095,34609,296
SOCO,"1/3/2025 8 a.m. CST",34681,34471,35451,770
SOCO,"1/3/2025 9 a.m. CST",33062,32825,33606,544
SOCO,"1/3/2025 10 a.m. CST",31088,30656,31317,229
SOCO,"1/3/2025 11 a.m. CST",29514,29039,30050,536
SOCO,"1/3/2025 12 p.m. CST",28354,27617,29049,695
SOCO,"1/3/2025 1 p.m. CST",27817,26622,28423,606
SOCO,"1/3/2025 2 p.m. CST",27213,26043,27781,568
SOCO,"1/3/2025 3 p.m. CST",26766,25576,27221,455
SOCO,"1/3/2025 4 p.m. CST",26545,25719,26829,284
SOCO,"1/3/2025 5 p.m. CST",27528,26971,27691,163
SOCO,"1/3/2025 6 p.m. CST",28727,28489,29122,395
SOCO,"1/3/2025 7 p.m. CST",29095,28848,29795,700
SOCO,"1/3/2025 8 p.m. CST",29294,29058,29939,645
SOCO,"1/3/2025 9 p.m. CST",29187,28927,29745,558
SOCO,"1/3/2025 10 p.m. CST",28768,28507,29141,373
SOCO,"1/3/2025 11 p.m. CST",28644,27983,28809,165
SOCO,"1/4/2025 12 a.m. CST",28183,27533,28430,247
SOCO,"1/4/2025 1 a.m. CST",28007,27370,28539,532
SOCO,"1/4/2025 2 a.m. CST",28163,27513,28950,787
SOCO,"1/4/2025 3 a.m. CST",28360,27766,29088,728
SOCO,"1/4/2025 4 a.m. CST",28871,28265,29547,676
SOCO,"1/4/2025 5 a.m. CST",29748,29256,30555,807
SOCO,"1/4/2025 6 a.m. CST",30721,30466,31550,829
SOCO,"1/4/2025 7 a.m. CST",32038,31775,32902,864
SOCO,"1/4/2025 8 a.m. CST",32942,32666,33845,903
SOCO,"1/4/2025 9 a.m. CST",32250,31935,33007,757
SOCO,"1/4/2025 10 a.m. CST",30935,30614,31425,490
SOCO,"1/4/2025 11 a.m. CST",29718,29315,30034,316
SOCO,"1/4/2025 12 p.m. CST",28730,28071,29095,365
SOCO,"1/4/2025 1 p.m. CST",27842,26983,28196,354
SOCO,"1/4/2025 2 p.m. CST",27154,26125,27616,462
SOCO,"1/4/2025 3 p.m. CST",26758,25648,27422,664
SOCO,"1/4/2025 4 p.m. CST",26498,25750,27181,683
SOCO,"1/4/2025 5 p.m. CST",27605,27023,28108,503
SOCO,"1/4/2025 6 p.m. CST",29334,28949,29878,544
SOCO,"1/4/2025 7 p.m. CST",30034,29658,30594,560
SOCO,"1/4/2025 8 p.m. CST",30344,29962,30833,489
SOCO,"1/4/2025 9 p.m. CST",30361,29976,30755,394
SOCO,"1/4/2025 10 p.m. CST",29750,29536,30370,620
SOCO,"1/4/2025 11 p.m. CST",29168,28946,29453,285
SOCO,"1/5/2025 12 a.m. CST",28663,28472,28956,293
SOCO,"1/5/2025 1 a.m. CST",28732,28102,28927,195
SOCO,"1/5/2025 2 a.m. CST",28550,27907,28898,348
SOCO,"1/5/2025 3 a.m. CST",28465,27794,28769,304
SOCO,"1/5/2025 4 a.m. CST",28139,27879,28307,168
SOCO,"1/5/2025 5 a.m. CST",28196,28042,28350,154
SOCO,"1/5/2025 6 a.m. CST",28544,28399,28910,366
SOCO,"1/5/2025 7 a.m. CST",29212,29058,29796,584
SOCO,"1/5/2025 8 a.m. CST",29633,29438,30333,700
SOCO,"1/5/2025 9 a.m. CST",29354,29151,29947,593
SOCO,"1/5/2025 10 a.m. CST",28621,28376,28707,86
SOCO,"1/5/2025 11 a.m. CST",27635,27383,27941,306
SOCO,"1/5/2025 12 p.m. CST",27301,26726,27783,482
SOCO,"1/5/2025 1 p.m. CST",27102,26326,27523,421
SOCO,"1/5/2025 2 p.m. CST",27137,26189,27764,627
SOCO,"1/5/2025 3 p.m. CST",26898,26051,27755,857
SOCO,"1/5/2025 4 p.m. CST",26862,26280,27729,867
SOCO,"1/5/2025 5 p.m. CST",27314,27096,28252,938
SOCO,"1/5/2025 6 p.m. CST",28216,28009,29149,933
SOCO,"1/5/2025 7 p.m. CST",28289,28088,29209,920
SOCO,"1/5/2025 8 p.m. CST",27788,27574,28683,895
SOCO,"1/5/2025 9 p.m. CST",26914,26712,27709,795
SOCO,"1/5/2025 10 p.m. CST",25620,25462,26466,846
SOCO,"1/5/2025 11 p.m. CST",24757,24267,25465,708
SOCO,"1/6/2025 12 a.m. CST",24011,23209,24870,859
SOCO,"1/6/2025 1 a.m. CST",22654,22487,23662,1008
SOCO,"1/6/2025 2 a.m. CST",22251,22117,23424,1173
SOCO,"1/6/2025 3 a.m. CST",22237,22101,23385,1148
SOCO,"1/6/2025 4 a.m. CST",22533,22388,23350,817
SOCO,"1/6/2025 5 a.m. CST",23649,23499,24576,927
SOCO,"1/6/2025 6 a.m. CST",25439,25289,26637,1198
SOCO,"1/6/2025 7 a.m. CST",27258,27047,28479,1221
SOCO,"1/6/2025 8 a.m. CST",28181,27981,29357,1176
SOCO,"1/6/2025 9 a.m. CST",28981,28792,30311,1330
SOCO,"1/6/2025 10 a.m. CST",29532,29211,30596,1064
SOCO,"1/6/2025 11 a.m. CST",30108,29782,31146,1038
SOCO,"1/6/2025 12 p.m. CST",30372,30029,31462,1090
SOCO,"1/6/2025 1 p.m. CST",30986,30633,32026,1040
SOCO,"1/6/2025 2 p.m. CST",31542,31186,32579,1037
SOCO,"1/6/2025 3 p.m. CST",32169,31796,33245,1076
SOCO,"1/6/2025 4 p.m. CST",33135,32795,34181,1046
SOCO,"1/6/2025 5 p.m. CST",34978,34601,35714,736
SOCO,"1/6/2025 6 p.m. CST",36864,36465,37166,302
SOCO,"1/6/2025 7 p.m. CST",37643,37290,38034,391
SOCO,"1/6/2025 8 p.m. CST",37661,37299,37991,330
SOCO,"1/6/2025 9 p.m. CST",37084,36650,37440,356
SOCO,"1/6/2025 10 p.m. CST",35876,35471,36255,379
SOCO,"1/6/2025 11 p.m. CST",34765,34400,35116,351
SOCO,"1/7/2025 12 a.m. CST",34128,33732,34469,341
SOCO,"1/7/2025 1 a.m. CST",33634,33361,33814,180
SOCO,"1/7/2025 2 a.m. CST",33658,33279,33956,298
SOCO,"1/7/2025 3 a.m. CST",33931,33533,34097,166
SOCO,"1/7/2025 4 a.m. CST",34645,34243,34817,172
SOCO,"1/7/2025 5 a.m. CST",36129,35788,36608,479
SOCO,"1/7/2025 6 a.m. CST",38449,38155,39286,837
SOCO,"1/7/2025 7 a.m. CST",40168,39840,41048,880
SOCO,"1/7/2025 8 a.m. CST",40027,39632,40896,869
SOCO,"1/7/2025 9 a.m. CST",38752,38345,39570,818
SOCO,"1/7/2025 10 a.m. CST",37245,36801,37768,523
SOCO,"1/7/2025 11 a.m. CST",35654,35215,35946,292
SOCO,"1/7/2025 12 p.m. CST",34016,33622,34084,68
SOCO,"1/7/2025 1 p.m. CST",32627,32259,32777,150
SOCO,"1/7/2025 2 p.m. CST",31436,31080,31605,169
SOCO,"1/7/2025 3 p.m. CST",30839,30495,31279,440
SOCO,"1/7/2025 4 p.m. CST",31247,30929,31629,382
SOCO,"1/7/2025 5 p.m. CST",32901,32563,33599,698
SOCO,"1/7/2025 6 p.m. CST",35510,35155,36622,1112
SOCO,"1/7/2025 7 p.m. CST",36604,36228,37655,1051
SOCO,"1/7/2025 8 p.m. CST",37070,36688,38103,1033
SOCO,"1/7/2025 9 p.m. CST",36915,36525,37899,984
SOCO,"1/7/2025 10 p.m. CST",35980,35546,36919,939
SOCO,"1/7/2025 11 p.m. CST",35169,34820,35769,600
SOCO,"1/8/2025 12 a.m. CST",34704,34390,35666,962
SOCO,"1/8/2025 1 a.m. CST",34821,34501,35638,817
SOCO,"1/8/2025 2 a.m. CST",35066,34745,36057,991
SOCO,"1/8/2025 3 a.m. CST",35596,35277,36523,927
SOCO,"1/8/2025 4 a.m. CST",36449,36104,37494,1045
SOCO,"1/8/2025 5 a.m. CST",37997,37309,38864,867
SOCO,"1/8/2025 6 a.m. CST",40390,39714,41226,836
SOCO,"1/8/2025 7 a.m. CST",41862,41226,43188,1326
SOCO,"1/8/2025 8 a.m. CST",41417,40791,42783,1366
SOCO,"1/8/2025 9 a.m. CST",40240,39651,41553,1313
SOCO,"1/8/2025 10 a.m. CST",38511,38042,39032,521
SOCO,"1/8/2025 11 a.m. CST",36727,36268,37070,343
SOCO,"1/8/2025 12 p.m. CST",34950,34580,35411,461
SOCO,"1/8/2025 1 p.m. CST",33482,33109,34213,731
SOCO,"1/8/2025 2 p.m. CST",32252,31897,33066,814
SOCO,"1/8/2025 3 p.m. CST",31711,31277,32941,1230
SOCO,"1/8/2025 4 p.m. CST",32173,31869,33118,945
SOCO,"1/8/2025 5 p.m. CST",33904,33627,34922,1018
SOCO,"1/8/2025 6 p.m. CST",36481,36189,37808,1327
SOCO,"1/8/2025 7 p.m. CST",37656,37375,38901,1245
SOCO,"1/8/2025 8 p.m. CST",38061,37791,39074,1013
SOCO,"1/8/2025 9 p.m. CST",37755,37500,38657,902
SOCO,"1/8/2025 10 p.m. CST",36851,36515,37736,885
SOCO,"1/8/2025 11 p.m. CST",35901,35581,36278,377
SOCO,"1/9/2025 12 a.m. CST",35475,35173,35902,427
SOCO,"1/9/2025 1 a.m. CST",35364,35052,36012,648
SOCO,"1/9/2025 2 a.m. CST",35659,35334,36331,672
SOCO,"1/9/2025 3 a.m. CST",36123,35786,36890,767
SOCO,"1/9/2025 4 a.m. CST",36887,36552,37822,935
SOCO,"1/9/2025 5 a.m. CST",38400,37775,39415,1015
SOCO,"1/9/2025 6 a.m. CST",40988,40349,42023,1035
SOCO,"1/9/2025 7 a.m. CST",42769,42183,43808,1039
SOCO,"1/9/2025 8 a.m. CST",42571,41981,43696,1125
SOCO,"1/9/2025 9 a.m. CST",40722,40116,42040,1318
SOCO,"1/9/2025 10 a.m. CST",38598,38142,39105,507
SOCO,"1/9/2025 11 a.m. CST",36409,35985,36553,144
SOCO,"1/9/2025 12 p.m. CST",34448,34063,34723,275
SOCO,"1/9/2025 1 p.m. CST",32699,32359,33317,618
SOCO,"1/9/2025 2 p.m. CST",31437,31089,32053,616
SOCO,"1/9/2025 3 p.m. CST",30768,30394,31473,705
SOCO,"1/9/2025 4 p.m. CST",31008,30668,31826,818
SOCO,"1/9/2025 5 p.m. CST",32470,32190,33753,1283
SOCO,"1/9/2025 6 p.m. CST",34875,34581,36566,1691
SOCO,"1/9/2025 7 p.m. CST",35848,35611,37470,1622
SOCO,"1/9/2025 8 p.m. CST",36092,35754,37639,1547
SOCO,"1/9/2025 9 p.m. CST",35695,35395,36974,1279
SOCO,"1/9/2025 10 p.m. CST",34647,34362,36153,1506
SOCO,"1/9/2025 11 p.m. CST",33552,33253,34999,1447
SOCO,"1/10/2025 12 a.m. CST",32701,31982,34339,1638
SOCO,"1/10/2025 1 a.m. CST",31955,31706,33484,1529
SOCO,"1/10/2025 2 a.m. CST",31429,31219,32994,1565
SOCO,"1/10/2025 3 a.m. CST",31270,31019,32768,1498
SOCO,"1/10/2025 4 a.m. CST",31226,30993,32496,1270
SOCO,"1/10/2025 5 a.m. CST",31762,31322,33173,1411
SOCO,"1/10/2025 6 a.m. CST",32993,32519,34442,1449
SOCO,"1/10/2025 7 a.m. CST",34282,33907,35848,1566
SOCO,"1/10/2025 8 a.m. CST",35183,34817,36436,1253
SOCO,"1/10/2025 9 a.m. CST",35820,35370,36808,988
SOCO,"1/10/2025 10 a.m. CST",36139,35809,36970,831
SOCO,"1/10/2025 11 a.m. CST",35949,35691,36836,887
SOCO,"1/10/2025 12 p.m. CST",35737,35450,36418,681
SOCO,"1/10/2025 1 p.m. CST",35419,35161,35797,378
SOCO,"1/10/2025 2 p.m. CST",35163,34897,35460,297
SOCO,"1/10/2025 3 p.m. CST",35121,34819,35882,761
SOCO,"1/10/2025 4 p.m. CST",35463,35209,36224,761
SOCO,"1/10/2025 5 p.m. CST",36085,35810,36799,714
SOCO,"1/10/2025 6 p.m. CST",36403,36115,37294,891
SOCO,"1/10/2025 7 p.m. CST",35802,35523,37215,1413
SOCO,"1/10/2025 8 p.m. CST",34932,34636,36199,1267
SOCO,"1/10/2025 9 p.m. CST",34048,33743,35037,989
SOCO,"1/10/2025 10 p.m. CST",32961,32680,33876,915
SOCO,"1/10/2025 11 p.m. CST",31830,31519,32539,709
SOCO,"1/11/2025 12 a.m. CST",30909,30615,31762,853
SOCO,"1/11/2025 1 a.m. CST",30358,30046,30887,529
SOCO,"1/11/2025 2 a.m. CST",30040,29741,30658,618
SOCO,"1/11/2025 3 a.m. CST",30049,29736,30902,853
SOCO,"1/11/2025 4 a.m. CST",30258,29956,31074,816
SOCO,"1/11/2025 5 a.m. CST",30798,30502,32013,1215
SOCO,"1/11/2025 6 a.m. CST",31535,31239,32732,1197
SOCO,"1/11/2025 7 a.m. CST",32503,32163,33559,1056
SOCO,"1/11/2025 8 a.m. CST",33669,33323,34590,921
SOCO,"1/11/2025 9 a.m. CST",34829,34466,35315,486
SOCO,"1/11/2025 10 a.m. CST",35421,35062,35650,229
SOCO,"1/11/2025 11 a.m. CST",35380,35033,35616,236
SOCO,"1/11/2025 12 p.m. CST",34789,34457,34861,72
SOCO,"1/11/2025 1 p.m. CST",33907,33559,33871,-36
SOCO,"1/11/2025 2 p.m. CST",32730,32415,32678,-52
SOCO,"1/11/2025 3 p.m. CST",32068,31776,32334,266
SOCO,"1/11/2025 4 p.m. CST",32040,31746,32540,500
SOCO,"1/11/2025 5 p.m. CST",33074,32806,33777,703
SOCO,"1/11/2025 6 p.m. CST",34977,34705,35664,687
SOCO,"1/11/2025 7 p.m. CST",35783,35500,36486,703
SOCO,"1/11/2025 8 p.m. CST",36220,35904,36692,472
SOCO,"1/11/2025 9 p.m. CST",36364,36062,36565,201
SOCO,"1/11/2025 10 p.m. CST",36123,35782,36286,163
SOCO,"1/11/2025 11 p.m. CST",35846,35562,35725,-121
SOCO,"1/12/2025 12 a.m. CST",35558,35251,35712,154
SOCO,"1/12/2025 1 a.m. CST",35592,35260,35560,-32
SOCO,"1/12/2025 2 a.m. CST",35864,35554,36056,192
SOCO,"1/12/2025 3 a.m. CST",36399,36087,36438,39
SOCO,"1/12/2025 4 a.m. CST",37074,36755,36974,-100
SOCO,"1/12/2025 5 a.m. CST",37896,37578,37966,70
SOCO,"1/12/2025 6 a.m. CST",38974,38653,39168,194
SOCO,"1/12/2025 7 a.m. CST",40225,39876,40157,-68
SOCO,"1/12/2025 8 a.m. CST",40920,40554,40785,-135
SOCO,"1/12/2025 9 a.m. CST",39455,39063,38896,-559
SOCO,"1/12/2025 10 a.m. CST",36723,36303,36206,-517
SOCO,"1/12/2025 11 a.m. CST",34137,33716,34174,37
SOCO,"1/12/2025 12 p.m. CST",32122,31712,32191,69
SOCO,"1/12/2025 1 p.m. CST",30545,30115,30582,37
SOCO,"1/12/2025 2 p.m. CST",29277,28891,29550,273
SOCO,"1/12/2025 3 p.m. CST",28679,28284,29115,436
SOCO,"1/12/2025 4 p.m. CST",28810,28431,29387,577
SOCO,"1/12/2025 5 p.m. CST",30089,29793,30688,599
SOCO,"1/12/2025 6 p.m. CST",32231,31928,33073,842
SOCO,"1/12/2025 7 p.m. CST",33086,32774,33924,838
SOCO,"1/12/2025 8 p.m. CST",33380,33085,34099,719
SOCO,"1/12/2025 9 p.m. CST",32931,32664,33379,448
SOCO,"1/12/2025 10 p.m. CST",31717,31464,32394,677
SOCO,"1/12/2025 11 p.m. CST",30397,30165,30997,600
SOCO,"1/13/2025 12 a.m. CST",29434,29213,30003,569
SOCO,"1/13/2025 1 a.m. CST",28621,28510,29276,655
SOCO,"1/13/2025 2 a.m. CST",28284,28157,29116,832
SOCO,"1/13/2025 3 a.m. CST",28271,28130,29059,788
SOCO,"1/13/2025 4 a.m. CST",28868,28733,29568,700
SOCO,"1/13/2025 5 a.m. CST",30105,29981,31224,1119
SOCO,"1/13/2025 6 a.m. CST",32067,31941,32912,845
SOCO,"1/13/2025 7 a.m. CST",33793,33713,34830,1037
SOCO,"1/13/2025 8 a.m. CST",33884,33806,34743,859
SOCO,"1/13/2025 9 a.m. CST",33536,33387,34104,568
SOCO,"1/13/2025 10 a.m. CST",32622,32489,33153,531
SOCO,"1/13/2025 11 a.m. CST",31551,31404,31953,402
SOCO,"1/13/2025 12 p.m. CST",30432,30287,30828,396
SOCO,"1/13/2025 1 p.m. CST",29512,29371,29853,341
SOCO,"1/13/2025 2 p.m. CST",28717,28594,29144,427
SOCO,"1/13/2025 3 p.m. CST",28289,28174,29133,844
SOCO,"1/13/2025 4 p.m. CST",28381,28301,29364,983
SOCO,"1/13/2025 5 p.m. CST",29318,29235,30359,1041
SOCO,"1/13/2025 6 p.m. CST",31235,31224,32123,888
SOCO,"1/13/2025 7 p.m. CST",31975,31977,32846,871
SOCO,"1/13/2025 8 p.m. CST",32187,32150,33048,861
SOCO,"1/13/2025 9 p.m. CST",31674,31617,32624,950
SOCO,"1/13/2025 10 p.m. CST",30789,30652,31362,573
SOCO,"1/13/2025 11 p.m. CST",29962,29820,30466,504
SOCO,"1/14/2025 12 a.m. CST",29459,29313,30201,742
SOCO,"1/14/2025 1 a.m. CST",29451,29192,30262,811
SOCO,"1/14/2025 2 a.m. CST",29923,29662,30616,693
SOCO,"1/14/2025 3 a.m. CST",30716,30440,31453,737
SOCO,"1/14/2025 4 a.m. CST",31826,31540,32551,725
SOCO,"1/14/2025 5 a.m. CST",33784,33500,34246,462
SOCO,"1/14/2025 6 a.m. CST",36568,36299,36687,119
SOCO,"1/14/2025 7 a.m. CST",38763,38458,39334,571
SOCO,"1/14/2025 8 a.m. CST",38703,38405,39305,602
SOCO,"1/14/2025 9 a.m. CST",37029,36616,37824,795
SOCO,"1/14/2025 10 a.m. CST",34851,34444,36063,1212
SOCO,"1/14/2025 11 a.m. CST",32920,32539,33767,847
SOCO,"1/14/2025 12 p.m. CST",31172,30847,32042,870
SOCO,"1/14/2025 1 p.m. CST",29832,29514,30717,885
SOCO,"1/14/2025 2 p.m. CST",28694,28396,29736,1042
SOCO,"1/14/2025 3 p.m. CST",28101,27795,29358,1257
SOCO,"1/14/2025 4 p.m. CST",28360,28082,29746,1386
SOCO,"1/14/2025 5 p.m. CST",29721,29461,31262,1541
SOCO,"1/14/2025 6 p.m. CST",31976,31778,33380,1404
SOCO,"1/14/2025 7 p.m. CST",32985,32767,34187,1202
SOCO,"1/14/2025 8 p.m. CST",33158,33023,34210,1052
SOCO,"1/14/2025 9 p.m. CST",32832,32619,33790,958
SOCO,"1/14/2025 10 p.m. CST",31922,31646,33098,1176
SOCO,"1/14/2025 11 p.m. CST",30762,30593,31809,1047
SOCO,"1/15/2025 12 a.m. CST",30121,29946,31345,1224
SOCO,"1/15/2025 1 a.m. CST",29871,29641,31169,1298
SOCO,"1/15/2025 2 a.m. CST",29900,29569,31162,1262
SOCO,"1/15/2025 3 a.m. CST",30282,29933,31501,1219
SOCO,"1/15/2025 4 a.m. CST",31004,30684,32245,1241
SOCO,"1/15/2025 5 a.m. CST",32320,32049,33600,1280
SOCO,"1/15/2025 6 a.m. CST",34924,34560,35896,972
SOCO,"1/15/2025 7 a.m. CST",36554,36435,37632,1078
SOCO,"1/15/2025 8 a.m. CST",36608,36248,38237,1629
SOCO,"1/15/2025 9 a.m. CST",35086,34742,36627,1541
SOCO,"1/15/2025 10 a.m. CST",33143,32790,34199,1056
SOCO,"1/15/2025 11 a.m. CST",31448,31107,32637,1189
SOCO,"1/15/2025 12 p.m. CST",29892,29585,31083,1191
SOCO,"1/15/2025 1 p.m. CST",28648,28344,29932,1284
SOCO,"1/15/2025 2 p.m. CST",27719,27437,29000,1281
SOCO,"1/15/2025 3 p.m. CST",27191,26920,28488,1297
SOCO,"1/15/2025 4 p.m. CST",27285,27026,28740,1455
SOCO,"1/15/2025 5 p.m. CST",28606,28337,30366,1760
SOCO,"1/15/2025 6 p.m. CST",30847,30579,32317,1470
SOCO,"1/15/2025 7 p.m. CST",31869,31685,33356,1487
SOCO,"1/15/2025 8 p.m. CST",32342,32107,33760,1418
SOCO,"1/15/2025 9 p.m. CST",32240,31996,33553,1313
SOCO,"1/15/2025 10 p.m. CST",31439,31207,32508,1069
SOCO,"1/15/2025 11 p.m. CST",30512,30296,31410,898
SOCO,"1/16/2025 12 a.m. CST",30005,29780,30861,856
SOCO,"1/16/2025 1 a.m. CST",29791,29568,30775,984
SOCO,"1/16/2025 2 a.m. CST",29923,29690,31012,1089
SOCO,"1/16/2025 3 a.m. CST",30366,30114,31641,1275
SOCO,"1/16/2025 4 a.m. CST",31249,31022,32675,1426
SOCO,"1/16/2025 5 a.m. CST",32999,32761,33987,988
SOCO,"1/16/2025 6 a.m. CST",35707,35426,36755,1048
SOCO,"1/16/2025 7 a.m. CST",37715,37398,38827,1112
SOCO,"1/16/2025 8 a.m. CST",37431,37169,38880,1449
SOCO,"1/16/2025 9 a.m. CST",35114,34752,36158,1044
SOCO,"1/16/2025 10 a.m. CST",32478,32111,33259,781
SOCO,"1/16/2025 11 a.m. CST",30450,30142,31024,574
SOCO,"1/16/2025 12 p.m. CST",28895,28589,29360,465
SOCO,"1/16/2025 1 p.m. CST",27872,27605,28289,417
SOCO,"1/16/2025 2 p.m. CST",26896,26626,27481,585
SOCO,"1/16/2025 3 p.m. CST",26317,26083,27017,700
SOCO,"1/16/2025 4 p.m. CST",26427,26207,27072,645
SOCO,"1/16/2025 5 p.m. CST",27325,27133,28146,821
SOCO,"1/16/2025 6 p.m. CST",29194,29041,30037,843
SOCO,"1/16/2025 7 p.m. CST",30169,29948,31430,1261
SOCO,"1/16/2025 8 p.m. CST",30612,30389,31678,1066
SOCO,"1/16/2025 9 p.m. CST",30383,30128,31362,979
SOCO,"1/16/2025 10 p.m. CST",29496,29239,30457,961
SOCO,"1/16/2025 11 p.m. CST",28635,28382,29279,644
SOCO,"1/17/2025 12 a.m. CST",28182,27937,28831,649
SOCO,"1/17/2025 1 a.m. CST",28097,27836,28673,576
SOCO,"1/17/2025 2 a.m. CST",28477,28215,29154,677
SOCO,"1/17/2025 3 a.m. CST",29111,28819,29623,512
SOCO,"1/17/2025 4 a.m. CST",30195,29876,30784,589
SOCO,"1/17/2025 5 a.m. CST",32029,31719,32595,566
SOCO,"1/17/2025 6 a.m. CST",34800,34451,35418,618
SOCO,"1/17/2025 7 a.m. CST",36913,36600,37105,192
SOCO,"1/17/2025 8 a.m. CST",36901,36512,37486,585
SOCO,"1/17/2025 9 a.m. CST",34527,34151,35378,851
SOCO,"1/17/2025 10 a.m. CST",31659,31276,31946,287
SOCO,"1/17/2025 11 a.m. CST",29414,29070,29541,127
SOCO,"1/17/2025 12 p.m. CST",27860,27531,27915,55
SOCO,"1/17/2025 1 p.m. CST",26615,26327,26765,150
SOCO,"1/17/2025 2 p.m. CST",25673,25399,25834,161
SOCO,"1/17/2025 3 p.m. CST",25067,24808,25402,335
SOCO,"1/17/2025 4 p.m. CST",25177,24931,25219,42
SOCO,"1/17/2025 5 p.m. CST",26139,25894,26175,36
SOCO,"1/17/2025 6 p.m. CST",27667,27451,27955,288
SOCO,"1/17/2025 7 p.m. CST",27964,27735,28061,97
SOCO,"1/17/2025 8 p.m. CST",27770,27544,27939,169
SOCO,"1/17/2025 9 p.m. CST",27407,27155,27433,26
SOCO,"1/17/2025 10 p.m. CST",26540,26307,26655,115
SOCO,"1/17/2025 11 p.m. CST",25527,25292,25240,-287
SOCO,"1/18/2025 12 a.m. CST",24675,24449,24372,-303
SOCO,"1/18/2025 1 a.m. CST",24073,23858,24230,157
SOCO,"1/18/2025 2 a.m. CST",23754,23568,24035,281
SOCO,"1/18/2025 3 a.m. CST",23552,23350,24095,543
SOCO,"1/18/2025 4 a.m. CST",23595,23392,24132,537
SOCO,"1/18/2025 5 a.m. CST",23923,23735,24466,543
SOCO,"1/18/2025 6 a.m. CST",24674,24483,25490,816
SOCO,"1/18/2025 7 a.m. CST",25538,25315,26575,1037
SOCO,"1/18/2025 8 a.m. CST",26432,26200,27233,801
SOCO,"1/18/2025 9 a.m. CST",27155,26931,27642,487
SOCO,"1/18/2025 10 a.m. CST",27342,27105,27172,-170
SOCO,"1/18/2025 11 a.m. CST",27062,26817,27100,38
SOCO,"1/18/2025 12 p.m. CST",26433,26213,26351,-82
SOCO,"1/18/2025 1 p.m. CST",25795,25573,25853,58
SOCO,"1/18/2025 2 p.m. CST",25287,25086,25310,23
SOCO,"1/18/2025 3 p.m. CST",24902,24703,25377,475
SOCO,"1/18/2025 4 p.m. CST",24842,24649,25140,298
SOCO,"1/18/2025 5 p.m. CST",25156,24979,25336,180
SOCO,"1/18/2025 6 p.m. CST",25996,25817,26002,6
SOCO,"1/18/2025 7 p.m. CST",25891,25691,26206,315
SOCO,"1/18/2025 8 p.m. CST",25471,25280,25718,247
SOCO,"1/18/2025 9 p.m. CST",24803,24626,25092,289
SOCO,"1/18/2025 10 p.m. CST",24046,23842,24543,497
SOCO,"1/18/2025 11 p.m. CST",23145,22964,23727,582
SOCO,"1/19/2025 12 a.m. CST",22315,22134,22804,489
SOCO,"1/19/2025 1 a.m. CST",21656,21477,22549,893
SOCO,"1/19/2025 2 a.m. CST",21263,21086,22334,1071
SOCO,"1/19/2025 3 a.m. CST",21089,20912,21953,864
SOCO,"1/19/2025 4 a.m. CST",21231,21007,21780,549
SOCO,"1/19/2025 5 a.m. CST",21719,21496,22208,489
SOCO,"1/19/2025 6 a.m. CST",22601,22370,23188,587
SOCO,"1/19/2025 7 a.m. CST",23801,23568,24426,625
SOCO,"1/19/2025 8 a.m. CST",25273,24969,26005,732
SOCO,"1/19/2025 9 a.m. CST",26639,26345,27515,876
SOCO,"1/19/2025 10 a.m. CST",27426,27098,28175,749
SOCO,"1/19/2025 11 a.m. CST",28018,27679,29287,1269
SOCO,"1/19/2025 12 p.m. CST",28385,28098,29666,1281
SOCO,"1/19/2025 1 p.m. CST",28712,28430,30199,1487
SOCO,"1/19/2025 2 p.m. CST",28951,28652,30444,1493
SOCO,"1/19/2025 3 p.m. CST",29379,29092,31091,1712
SOCO,"1/19/2025 4 p.m. CST",30221,29959,31390,1169
SOCO,"1/19/2025 5 p.m. CST",31723,31466,32858,1135
SOCO,"1/19/2025 6 p.m. CST",33795,33506,34960,1165
SOCO,"1/19/2025 7 p.m. CST",34724,34399,35694,970
SOCO,"1/19/2025 8 p.m. CST",35102,34764,35811,709
SOCO,"1/19/2025 9 p.m. CST",35109,34777,35729,620
SOCO,"1/19/2025 10 p.m. CST",34756,34385,35118,362
SOCO,"1/19/2025 11 p.m. CST",34238,33899,34779,541
SOCO,"1/20/2025 12 a.m. CST",34146,33804,34888,742
SOCO,"1/20/2025 1 a.m. CST",34314,33974,35188,874
SOCO,"1/20/2025 2 a.m. CST",34768,34483,35657,889
SOCO,"1/20/2025 3 a.m. CST",35515,35223,36449,934
SOCO,"1/20/2025 4 a.m. CST",36516,36076,37607,1091
SOCO,"1/20/2025 5 a.m. CST",38040,37424,39131,1091
SOCO,"1/20/2025 6 a.m. CST",39986,39380,40700,714
SOCO,"1/20/2025 7 a.m. CST",41883,41135,42816,933
SOCO,"1/20/2025 8 a.m. CST",42740,41983,43368,628
SOCO,"1/20/2025 9 a.m. CST",42149,41368,43127,978
SOCO,"1/20/2025 10 a.m. CST",41161,40646,41506,345
SOCO,"1/20/2025 11 a.m. CST",39465,39019,39387,-78
SOCO,"1/20/2025 12 p.m. CST",37802,37352,37627,-175
SOCO,"1/20/2025 1 p.m. CST",36501,36099,36638,137
SOCO,"1/20/2025 2 p.m. CST",35337,34968,35613,276
SOCO,"1/20/2025 3 p.m. CST",34680,34331,34948,268
SOCO,"1/20/2025 4 p.m. CST",34824,34509,35216,392
SOCO,"1/20/2025 5 p.m. CST",36594,36120,36852,258
SOCO,"1/20/2025 6 p.m. CST",39164,38699,40034,870
SOCO,"1/20/2025 7 p.m. CST",40752,40273,41816,1064
SOCO,"1/20/2025 8 p.m. CST",41033,40472,41910,877
SOCO,"1/20/2025 9 p.m. CST",40891,40436,41831,940
SOCO,"1/20/2025 10 p.m. CST",40184,39649,40971,787
SOCO,"1/20/2025 11 p.m. CST",39301,38905,39672,371
SOCO,"1/21/2025 12 a.m. CST",38998,38624,39715,717
SOCO,"1/21/2025 1 a.m. CST",38562,38223,39389,827
SOCO,"1/21/2025 2 a.m. CST",38406,38029,39021,615
SOCO,"1/21/2025 3 a.m. CST",38150,37773,39137,987
SOCO,"1/21/2025 4 a.m. CST",38361,37783,39773,1412
SOCO,"1/21/2025 5 a.m. CST",39068,38431,40225,1157
SOCO,"1/21/2025 6 a.m. CST",40461,39761,41622,1161
SOCO,"1/21/2025 7 a.m. CST",41636,40905,42376,740
SOCO,"1/21/2025 8 a.m. CST",42161,41395,43370,1209
SOCO,"1/21/2025 9 a.m. CST",42575,41762,44088,1513
SOCO,"1/21/2025 10 a.m. CST",42386,41810,42991,605
SOCO,"1/21/2025 11 a.m. CST",41969,41422,42407,438
SOCO,"1/21/2025 12 p.m. CST",41604,41018,41924,320
SOCO,"1/21/2025 1 p.m. CST",41349,40821,41660,311
SOCO,"1/21/2025 2 p.m. CST",41336,40781,41561,225
SOCO,"1/21/2025 3 p.m. CST",41603,41078,41540,-63
SOCO,"1/21/2025 4 p.m. CST",42204,41685,42012,-192
SOCO,"1/21/2025 5 p.m. CST",43202,42587,43371,169
SOCO,"1/21/2025 6 p.m. CST",44130,43524,44089,-41
SOCO,"1/21/2025 7 p.m. CST",43964,43356,43949,-15
SOCO,"1/21/2025 8 p.m. CST",43362,42787,43500,138
SOCO,"1/21/2025 9 p.m. CST",42537,41979,42679,142
SOCO,"1/21/2025 10 p.m. CST",41368,40766,41673,305
SOCO,"1/21/2025 11 p.m. CST",40404,39945,41018,614
SOCO,"1/22/2025 12 a.m. CST",39815,39404,40580,765
SOCO,"1/22/2025 1 a.m. CST",39672,39251,40081,409
SOCO,"1/22/2025 2 a.m. CST",39791,39362,39994,203
SOCO,"1/22/2025 3 a.m. CST",40198,39738,40332,134
SOCO,"1/22/2025 4 a.m. CST",40912,40240,41533,621
SOCO,"1/22/2025 5 a.m. CST",42210,41447,42654,444
SOCO,"1/22/2025 6 a.m. CST",43970,43244,44391,421
SOCO,"1/22/2025 7 a.m. CST",45750,45158,46491,741
SOCO,"1/22/2025 8 a.m. CST",46490,45913,47133,643
SOCO,"1/22/2025 9 a.m. CST",44989,44302,45716,727
SOCO,"1/22/2025 10 a.m. CST",42802,42302,43183,381
SOCO,"1/22/2025 11 a.m. CST",40765,40285,41135,370
SOCO,"1/22/2025 12 p.m. CST",38891,38416,39265,374
SOCO,"1/22/2025 1 p.m. CST",37030,36592,37573,543
SOCO,"1/22/2025 2 p.m. CST",35679,35245,36066,387
SOCO,"1/22/2025 3 p.m. CST",34597,34173,35192,595
SOCO,"1/22/2025 4 p.m. CST",34434,34064,35188,754
SOCO,"1/22/2025 5 p.m. CST",35860,35485,36696,836
SOCO,"1/22/2025 6 p.m. CST",38674,38254,39668,994
SOCO,"1/22/2025 7 p.m. CST",40004,39575,40854,850
SOCO,"1/22/2025 8 p.m. CST",40410,39962,41003,593
SOCO,"1/22/2025 9 p.m. CST",40412,39961,41199,787
SOCO,"1/22/2025 10 p.m. CST",39832,39378,40591,759
SOCO,"1/22/2025 11 p.m. CST",39314,38873,39890,576
SOCO,"1/23/2025 12 a.m. CST",39166,38743,39689,523
SOCO,"1/23/2025 1 a.m. CST",39232,38815,39580,348
SOCO,"1/23/2025 2 a.m. CST",39546,39128,40020,474
SOCO,"1/23/2025 3 a.m. CST",39888,39495,40978,1090
SOCO,"1/23/2025 4 a.m. CST",40554,40142,41562,1008
SOCO,"1/23/2025 5 a.m. CST",41573,41063,42463,890
SOCO,"1/23/2025 6 a.m. CST",43198,42611,43878,680
SOCO,"1/23/2025 7 a.m. CST",44616,44031,45461,845
SOCO,"1/23/2025 8 a.m. CST",44925,44298,46069,1144
SOCO,"1/23/2025 9 a.m. CST",43883,43263,45242,1359
SOCO,"1/23/2025 10 a.m. CST",41910,41422,42649,739
SOCO,"1/23/2025 11 a.m. CST",40009,39586,40701,692
SOCO,"1/23/2025 12 p.m. CST",38392,37993,39224,832
SOCO,"1/23/2025 1 p.m. CST",36835,36456,37857,1022
SOCO,"1/23/2025 2 p.m. CST",35550,35220,36247,697
SOCO,"1/23/2025 3 p.m. CST",34694,34363,35304,610
SOCO,"1/23/2025 4 p.m. CST",34540,34256,34999,459
SOCO,"1/23/2025 5 p.m. CST",35329,35040,36124,795
SOCO,"1/23/2025 6 p.m. CST",37365,37027,38556,1191
SOCO,"1/23/2025 7 p.m. CST",38711,38349,39807,1096
SOCO,"1/23/2025 8 p.m. CST",39213,38839,40315,1102
SOCO,"1/23/2025 9 p.m. CST",39338,38977,40129,791
SOCO,"1/23/2025 10 p.m. CST",38658,38226,39597,939
SOCO,"1/23/2025 11 p.m. CST",37886,37517,38722,836
SOCO,"1/24/2025 12 a.m. CST",37592,37205,38185,593
SOCO,"1/24/2025 1 a.m. CST",37639,37277,38504,865
SOCO,"1/24/2025 2 a.m. CST",37928,37569,38739,811
SOCO,"1/24/2025 3 a.m. CST",38443,38062,39189,746
SOCO,"1/24/2025 4 a.m. CST",39279,38907,40212,933
SOCO,"1/24/2025 5 a.m. CST",40821,40343,41692,871
SOCO,"1/24/2025 6 a.m. CST",42924,42443,43655,731
SOCO,"1/24/2025 7 a.m. CST",44563,44083,45143,580
SOCO,"1/24/2025 8 a.m. CST",44131,43606,45113,982
SOCO,"1/24/2025 9 a.m. CST",41533,41099,42310,777
SOCO,"1/24/2025 10 a.m. CST",38302,37893,38935,633
SOCO,"1/24/2025 11 a.m. CST",35673,35306,36645,972
SOCO,"1/24/2025 12 p.m. CST",33820,33475,34712,892
SOCO,"1/24/2025 1 p.m. CST",32681,32330,33686,1005
SOCO,"1/24/2025 2 p.m. CST",31916,31430,32763,847
SOCO,"1/24/2025 3 p.m. CST",31287,30923,32003,716
SOCO,"1/24/2025 4 p.m. CST",31165,30903,31955,790
SOCO,"1/24/2025 5 p.m. CST",32096,31852,33245,1149
SOCO,"1/24/2025 6 p.m. CST",34195,33951,35383,1188
SOCO,"1/24/2025 7 p.m. CST",35609,35300,36838,1229
SOCO,"1/24/2025 8 p.m. CST",36243,35948,37411,1168
SOCO,"1/24/2025 9 p.m. CST",36629,36287,37875,1246
SOCO,"1/24/2025 10 p.m. CST",36570,36242,37936,1366
SOCO,"1/24/2025 11 p.m. CST",36249,35927,37735,1486
SOCO,"1/25/2025 12 a.m. CST",36194,35833,37419,1225
SOCO,"1/25/2025 1 a.m. CST",36391,36037,37559,1168
SOCO,"1/25/2025 2 a.m. CST",36877,36498,37916,1039
SOCO,"1/25/2025 3 a.m. CST",37455,37085,37921,466
SOCO,"1/25/2025 4 a.m. CST",38248,37837,38474,226
SOCO,"1/25/2025 5 a.m. CST",39419,39012,39810,391
SOCO,"1/25/2025 6 a.m. CST",40856,40431,41140,284
SOCO,"1/25/2025 7 a.m. CST",42002,41614,42322,320
SOCO,"1/25/2025 8 a.m. CST",42339,41896,43064,725
SOCO,"1/25/2025 9 a.m. CST",40179,39688,41366,1187
SOCO,"1/25/2025 10 a.m. CST",36741,36314,37752,1011
SOCO,"1/25/2025 11 a.m. CST",34112,33662,35031,919
SOCO,"1/25/2025 12 p.m. CST",31736,31360,32706,970
SOCO,"1/25/2025 1 p.m. CST",29818,29484,31086,1268
SOCO,"1/25/2025 2 p.m. CST",28370,28058,29521,1151
SOCO,"1/25/2025 3 p.m. CST",27297,26989,28456,1159
SOCO,"1/25/2025 4 p.m. CST",27391,27106,28390,999
SOCO,"1/25/2025 5 p.m. CST",28332,28076,29157,825
SOCO,"1/25/2025 6 p.m. CST",30533,30309,31519,986
SOCO,"1/25/2025 7 p.m. CST",32025,31860,32983,958
SOCO,"1/25/2025 8 p.m. CST",32864,32627,33676,812
SOCO,"1/25/2025 9 p.m. CST",33385,33136,34281,896
SOCO,"1/25/2025 10 p.m. CST",33366,33128,34154,788
SOCO,"1/25/2025 11 p.m. CST",33235,32998,33985,750
SOCO,"1/26/2025 12 a.m. CST",33016,32819,33559,543
SOCO,"1/26/2025 1 a.m. CST",32954,32741,33701,747
SOCO,"1/26/2025 2 a.m. CST",32962,32761,33532,570
SOCO,"1/26/2025 3 a.m. CST",33095,32904,33520,425
SOCO,"1/26/2025 4 a.m. CST",33278,33092,33706,428
SOCO,"1/26/2025 5 a.m. CST",33718,33546,34327,609
SOCO,"1/26/2025 6 a.m. CST",34432,34216,34840,408
SOCO,"1/26/2025 7 a.m. CST",35176,34993,35756,580
SOCO,"1/26/2025 8 a.m. CST",35629,35391,36049,420
SOCO,"1/26/2025 9 a.m. CST",34391,34095,35121,730
SOCO,"1/26/2025 10 a.m. CST",32092,31794,32972,880
SOCO,"1/26/2025 11 a.m. CST",29899,29601,30716,817
SOCO,"1/26/2025 12 p.m. CST",28415,28122,29298,883
SOCO,"1/26/2025 1 p.m. CST",27375,27095,28379,1004
SOCO,"1/26/2025 2 p.m. CST",26576,26287,27592,1016
SOCO,"1/26/2025 3 p.m. CST",26135,25863,27143,1008
SOCO,"1/26/2025 4 p.m. CST",26242,25968,27247,1005
SOCO,"1/26/2025 5 p.m. CST",27050,26813,27899,849
SOCO,"1/26/2025 6 p.m. CST",28451,28273,29236,785
SOCO,"1/26/2025 7 p.m. CST",28901,28741,29874,973
SOCO,"1/26/2025 8 p.m. CST",28791,28578,29462,671
SOCO,"1/26/2025 9 p.m. CST",28208,27992,29088,880
SOCO,"1/26/2025 10 p.m. CST",27343,27130,28348,1005
SOCO,"1/26/2025 11 p.m. CST",26075,25876,27228,1153
SOCO,"1/27/2025 12 a.m. CST",25156,24973,26369,1213
SOCO,"1/27/2025 1 a.m. CST",24237,24400,25528,1291
SOCO,"1/27/2025 2 a.m. CST",24097,24217,25360,1263
SOCO,"1/27/2025 3 a.m. CST",24152,24280,25395,1243
SOCO,"1/27/2025 4 a.m. CST",24593,24778,25911,1318
SOCO,"1/27/2025 5 a.m. CST",25919,26099,27096,1177
SOCO,"1/27/2025 6 a.m. CST",28085,28305,29275,1190
SOCO,"1/27/2025 7 a.m. CST",29636,29951,30716,1080
SOCO,"1/27/2025 8 a.m. CST",29736,30068,30687,951
SOCO,"1/27/2025 9 a.m. CST",30029,29855,30893,864
SOCO,"1/27/2025 10 a.m. CST",29348,29734,30163,815
SOCO,"1/27/2025 11 a.m. CST",28922,29496,29558,636
SOCO,"1/27/2025 12 p.m. CST",28455,29111,29062,607
SOCO,"1/27/2025 1 p.m. CST",28149,28741,28652,503
SOCO,"1/27/2025 2 p.m. CST",27968,28485,28370,402
SOCO,"1/27/2025 3 p.m. CST",27925,28303,28246,321
SOCO,"1/27/2025 4 p.m. CST",28189,28531,28909,720
SOCO,"1/27/2025 5 p.m. CST",28861,29126,29834,973
SOCO,"1/27/2025 6 p.m. CST",29965,30263,31240,1275
SOCO,"1/27/2025 7 p.m. CST",30198,30450,31486,1288
SOCO,"1/27/2025 8 p.m. CST",30114,30150,31215,1101
SOCO,"1/27/2025 9 p.m. CST",29226,29339,30252,1026
SOCO,"1/27/2025 10 p.m. CST",28086,28186,29174,1088
SOCO,"1/27/2025 11 p.m. CST",27145,27283,27681,536
SOCO,"1/28/2025 12 a.m. CST",26557,26678,27044,487
SOCO,"1/28/2025 1 a.m. CST",26719,26508,27580,861
SOCO,"1/28/2025 2 a.m. CST",26883,26685,27774,891
SOCO,"1/28/2025 3 a.m. CST",27326,27517,28032,706
SOCO,"1/28/2025 4 a.m. CST",28269,28310,28950,681
SOCO,"1/28/2025 5 a.m. CST",30144,29891,30750,606
SOCO,"1/28/2025 6 a.m. CST",32748,32329,33149,401
SOCO,"1/28/2025 7 a.m. CST",34684,33796,34982,298
SOCO,"1/28/2025 8 a.m. CST",34664,33654,35361,697
SOCO,"1/28/2025 9 a.m. CST",33392,32606,34185,793
SOCO,"1/28/2025 10 a.m. CST",31600,30806,32562,962
SOCO,"1/28/2025 11 a.m. CST",29955,29321,30883,928
SOCO,"1/28/2025 12 p.m. CST",28390,28117,29518,1128
SOCO,"1/28/2025 1 p.m. CST",27462,27234,28494,1032
SOCO,"1/28/2025 2 p.m. CST",26584,26513,27835,1251
SOCO,"1/28/2025 3 p.m. CST",25989,26027,27483,1494
SOCO,"1/28/2025 4 p.m. CST",25947,26250,27406,1459
SOCO,"1/28/2025 5 p.m. CST",26829,27130,28202,1373
SOCO,"1/28/2025 6 p.m. CST",28881,28890,30169,1288
SOCO,"1/28/2025 7 p.m. CST",29951,29760,31051,1100
SOCO,"1/28/2025 8 p.m. CST",30239,30061,31195,956
SOCO,"1/28/2025 9 p.m. CST",29833,29674,30485,652
SOCO,"1/28/2025 10 p.m. CST",28894,28810,29748,854
SOCO,"1/28/2025 11 p.m. CST",27797,27595,28325,528
SOCO,"1/29/2025 12 a.m. CST",27092,26841,27687,595
SOCO,"1/29/2025 1 a.m. CST",26418,26544,27075,657
SOCO,"1/29/2025 2 a.m. CST",26325,26511,27108,783
SOCO,"1/29/2025 3 a.m. CST",26562,26747,27371,809
SOCO,"1/29/2025 4 a.m. CST",27296,27451,27975,679
SOCO,"1/29/2025 5 a.m. CST",28797,28923,29647,850
SOCO,"1/29/2025 6 a.m. CST",31079,31239,31905,826
SOCO,"1/29/2025 7 a.m. CST",32411,32687,33073,662
SOCO,"1/29/2025 8 a.m. CST",31137,32291,32124,987
SOCO,"1/29/2025 9 a.m. CST",28145,30439,29137,992
SOCO,"1/29/2025 10 a.m. CST",25845,28816,26817,972
SOCO,"1/29/2025 11 a.m. CST",24543,27315,25550,1007
SOCO,"1/29/2025 12 p.m. CST",23604,26166,24750,1146
SOCO,"1/29/2025 1 p.m. CST",23841,25389,24195,354
SOCO,"1/29/2025 2 p.m. CST",22409,24920,23706,1297
SOCO,"1/29/2025 3 p.m. CST",22161,24533,23683,1522
SOCO,"1/29/2025 4 p.m. CST",22656,24449,24142,1486
SOCO,"1/29/2025 5 p.m. CST",24427,24965,25803,1376
SOCO,"1/29/2025 6 p.m. CST",26310,26421,28013,1703
SOCO,"1/29/2025 7 p.m. CST",26878,27252,28693,1815
SOCO,"1/29/2025 8 p.m. CST",26966,27012,28678,1712
SOCO,"1/29/2025 9 p.m. CST",26523,26595,28230,1707
SOCO,"1/29/2025 10 p.m. CST",25502,25644,27314,1812
SOCO,"1/29/2025 11 p.m. CST",24606,24604,26151,1545
SOCO,"1/30/2025 12 a.m. CST",23724,23858,25354,1630
SOCO,"1/30/2025 1 a.m. CST",23674,23478,25359,1685
SOCO,"1/30/2025 2 a.m. CST",23779,23591,25414,1635
SOCO,"1/30/2025 3 a.m. CST",24063,23739,25646,1583
SOCO,"1/30/2025 4 a.m. CST",24712,24363,26240,1528
SOCO,"1/30/2025 5 a.m. CST",26064,26198,27562,1498
SOCO,"1/30/2025 6 a.m. CST",28389,28731,30049,1660
SOCO,"1/30/2025 7 a.m. CST",29864,30328,31437,1573
SOCO,"1/30/2025 8 a.m. CST",29564,30271,31578,2014
SOCO,"1/30/2025 9 a.m. CST",28787,29395,30372,1585
SOCO,"1/30/2025 10 a.m. CST",27679,28244,28715,1036
SOCO,"1/30/2025 11 a.m. CST",26696,27496,27416,720
SOCO,"1/30/2025 12 p.m. CST",25838,26696,26584,746
SOCO,"1/30/2025 1 p.m. CST",25210,25890,25895,685
SOCO,"1/30/2025 2 p.m. CST",24721,25224,25506,785
SOCO,"1/30/2025 3 p.m. CST",24363,24845,25247,884
SOCO,"1/30/2025 4 p.m. CST",24352,25020,25486,1134
SOCO,"1/30/2025 5 p.m. CST",24622,26047,25981,1359
SOCO,"1/30/2025 6 p.m. CST",25802,27172,27081,1279
SOCO,"1/30/2025 7 p.m. CST",26241,27881,27517,1276
SOCO,"1/30/2025 8 p.m. CST",26019,28118,27257,1238
SOCO,"1/30/2025 9 p.m. CST",25319,27219,26624,1305
SOCO,"1/30/2025 10 p.m. CST",24148,25942,25621,1473
SOCO,"1/30/2025 11 p.m. CST",22882,24995,24041,1159
SOCO,"1/31/2025 12 a.m. CST",21913,23765,22792,879
SOCO,"1/31/2025 1 a.m. CST",21282,21066,21664,382
SOCO,"1/31/2025 2 a.m. CST",20866,20640,21450,584
SOCO,"1/31/2025 3 a.m. CST",20806,20589,21316,510
SOCO,"1/31/2025 4 a.m. CST",21138,20914,21488,350
SOCO,"1/31/2025 5 a.m. CST",22095,21900,22558,463
SOCO,"1/31/2025 6 a.m. CST",23973,23739,24417,444
SOCO,"1/31/2025 7 a.m. CST",25284,25131,26107,823
SOCO,"1/31/2025 8 a.m. CST",25342,25108,26130,788
SOCO,"1/31/2025 9 a.m. CST",25304,25049,25824,520
SOCO,"1/31/2025 10 a.m. CST",25260,25005,25785,525
SOCO,"1/31/2025 11 a.m. CST",25000,24725,25754,754
SOCO,"1/31/2025 12 p.m. CST",24839,24564,25409,570
SOCO,"1/31/2025 1 p.m. CST",24848,24588,25519,671
SOCO,"1/31/2025 2 p.m. CST",24740,24471,25390,650
SOCO,"1/31/2025 3 p.m. CST",24668,24399,25140,472
SOCO,"1/31/2025 4 p.m. CST",24725,24494,25440,715
SOCO,"1/31/2025 5 p.m. CST",24909,24737,25823,914
SOCO,"1/31/2025 6 p.m. CST",25453,25279,26348,895
SOCO,"1/31/2025 7 p.m. CST",25640,25382,26662,1022
SOCO,"1/31/2025 8 p.m. CST",25338,25096,26241,903
SOCO,"1/31/2025 9 p.m. CST",24829,24590,25670,841
SOCO,"1/31/2025 10 p.m. CST",24075,23834,24797,722
SOCO,"1/31/2025 11 p.m. CST",23137,22875,23744,607
SOCO,"2/1/2025 12 a.m. CST",22371,22136,23026,655
