"BA Code","Timestamp (Hour Ending)","Demand (MWh)","Demand Forecast (MWh)","Net Generation (MWh)","Total Interchange (MWh)"
SOCO,"1/1/2019, Central Time",485983,489574,510840,-24857
SOCO,"1/2/2019, Central Time",551637,529604,580831,-29194
SOCO,"1/3/2019, Central Time",571331,557245,595905,-24574
SOCO,"1/4/2019, Central Time",571781,577276,594302,-22521
SOCO,"1/5/2019, Central Time",575328,566848,592163,-16835
SOCO,"1/6/2019, Central Time",566077,547689,580989,-14912
SOCO,"1/7/2019, Central Time",590470,572870,612161,-21691
SOCO,"1/8/2019, Central Time",574439,553094,602337,-27898
SOCO,"1/9/2019, Central Time",625326,606212,649257,-23931
SOCO,"1/10/2019, Central Time",718664,708206,715629,3035
SOCO,"1/11/2019, Central Time",717152,704378,704706,12446
SOCO,"1/12/2019, Central Time",640984,627049,640675,309
SOCO,"1/13/2019, Central Time",617784,582672,627875,-10091
SOCO,"1/14/2019, Central Time",700554,672414,704640,-4086
SOCO,"1/15/2019, Central Time",727401,704345,730131,-2730
SOCO,"1/16/2019, Central Time",727658,701966,728966,-1308
SOCO,"1/17/2019, Central Time",704502,678984,706746,-2244
SOCO,"1/18/2019, Central Time",595031,579589,596401,-1370
SOCO,"1/19/2019, Central Time",549260,549831,542524,6736
SOCO,"1/20/2019, Central Time",694727,682350,683098,11629
SOCO,"1/21/2019, Central Time",794443,758635,778527,15916
SOCO,"1/22/2019, Central Time",743879,711492,737943,5936
SOCO,"1/23/2019, Central Time",617313,591083,630613,-13300
SOCO,"1/24/2019, Central Time",673355,656965,683059,-9704
SOCO,"1/25/2019, Central Time",744159,741598,763922,-19763
SOCO,"1/26/2019, Central Time",711294,701700,730001,-18707
SOCO,"1/27/2019, Central Time",682011,651309,704372,-22361
SOCO,"1/28/2019, Central Time",685412,674959,701390,-15978
SOCO,"1/29/2019, Central Time",721966,779650,738265,-16299
SOCO,"1/30/2019, Central Time",826734,868595,833481,-6747
SOCO,"1/31/2019, Central Time",766475,800145,771371,-4896
SOCO,"2/1/2019, Central Time",673780,678688,680321,-6541
SOCO,"2/2/2019, Central Time",559042,572561,568401,-9359
SOCO,"2/3/2019, Central Time",499678,510916,514927,-15249
SOCO,"2/4/2019, Central Time",543807,551326,558419,-14612
SOCO,"2/5/2019, Central Time",556366,540303,580709,-24343
SOCO,"2/6/2019, Central Time",551307,535905,580036,-28729
SOCO,"2/7/2019, Central Time",552231,537805,572399,-20168
SOCO,"2/8/2019, Central Time",555949,548242,580255,-24306
SOCO,"2/9/2019, Central Time",606442,583696,621151,-14709
SOCO,"2/10/2019, Central Time",609937,584459,623552,-13615
SOCO,"2/11/2019, Central Time",616448,584680,630305,-13857
SOCO,"2/12/2019, Central Time",577060,546263,605467,-28407
SOCO,"2/13/2019, Central Time",639364,608834,650959,-11595
SOCO,"2/14/2019, Central Time",647259,621239,655564,-8305
SOCO,"2/15/2019, Central Time",569639,554902,599781,-30142
SOCO,"2/16/2019, Central Time",517876,504269,554896,-37020
SOCO,"2/17/2019, Central Time",536609,497915,563849,-27240
SOCO,"2/18/2019, Central Time",583860,575530,615774,-31914
SOCO,"2/19/2019, Central Time",661590,617344,672680,-11090
SOCO,"2/20/2019, Central Time",656393,617515,674482,-18089
SOCO,"2/21/2019, Central Time",598085,579435,614755,-16670
SOCO,"2/22/2019, Central Time",572418,546346,597663,-25245
SOCO,"2/23/2019, Central Time",548317,532522,571302,-22984
SOCO,"2/24/2019, Central Time",516620,524286,544988,-28368
SOCO,"2/25/2019, Central Time",603373,606695,609309,-5936
SOCO,"2/26/2019, Central Time",583847,582175,610124,-26277
SOCO,"2/27/2019, Central Time",549628,549449,584377,-34749
SOCO,"2/28/2019, Central Time",551824,546348,582423,-30599
SOCO,"3/1/2019, Central Time",537651,536514,566898,-29247
SOCO,"3/2/2019, Central Time",512834,498754,542863,-30029
SOCO,"3/3/2019, Central Time",519872,,540493,-20621
SOCO,"3/4/2019, Central Time",673609,642375,690655,-17046
SOCO,"3/5/2019, Central Time",734746,735426,725389,9357
SOCO,"3/6/2019, Central Time",743076,746504,723153,19923
SOCO,"3/7/2019, Central Time",656009,679039,663997,-7988
SOCO,"3/8/2019, Central Time",573392,550332,592715,-19323
SOCO,"3/9/2019, Central Time",520752,514435,542790,-22038
SOCO,"3/10/2019, Central Time",487621,470006,519910,-32289
SOCO,"3/11/2019, Central Time",555210,538227,584561,-29351
SOCO,"3/12/2019, Central Time",558722,525352,575259,-16537
SOCO,"3/13/2019, Central Time",552579,530708,564255,-11676
SOCO,"3/14/2019, Central Time",557821,555559,569075,-11254
SOCO,"3/15/2019, Central Time",535739,527451,547944,-12205
SOCO,"3/16/2019, Central Time",542288,524102,546116,-3828
SOCO,"3/17/2019, Central Time",546318,527180,554081,-7763
SOCO,"3/18/2019, Central Time",594294,564698,596109,-1815
SOCO,"3/19/2019, Central Time",613259,597790,617459,-4200
SOCO,"3/20/2019, Central Time",608353,578131,614017,-5664
SOCO,"3/21/2019, Central Time",584318,565665,594730,-10412
SOCO,"3/22/2019, Central Time",573444,549904,588607,-15163
SOCO,"3/23/2019, Central Time",529773,511641,549559,-19786
SOCO,"3/24/2019, Central Time",508877,496430,531080,-22203
SOCO,"3/25/2019, Central Time",536367,531114,552970,-16603
SOCO,"3/26/2019, Central Time",544033,534945,561629,-17596
SOCO,"3/27/2019, Central Time",557428,540987,562282,-4854
SOCO,"3/28/2019, Central Time",567930,545936,566652,1278
SOCO,"3/29/2019, Central Time",543841,529859,547897,-4056
SOCO,"3/30/2019, Central Time",496857,490772,514110,-17253
SOCO,"3/31/2019, Central Time",499573,486202,533136,-33563
SOCO,"4/1/2019, Central Time",581390,559569,611292,-29902
SOCO,"4/2/2019, Central Time",561500,546585,587370,-25870
SOCO,"4/3/2019, Central Time",537200,538420,563719,-26519
SOCO,"4/4/2019, Central Time",541281,530121,577145,-35864
SOCO,"4/5/2019, Central Time",531134,520712,567554,-36420
SOCO,"4/6/2019, Central Time",508242,494356,539737,-31495
SOCO,"4/7/2019, Central Time",523828,504004,554647,-30819
SOCO,"4/8/2019, Central Time",560626,556534,587202,-26576
SOCO,"4/9/2019, Central Time",560347,555198,592342,-31995
SOCO,"4/10/2019, Central Time",581912,564902,609199,-27287
SOCO,"4/11/2019, Central Time",590290,564856,618559,-28269
SOCO,"4/12/2019, Central Time",588197,573876,617569,-29372
SOCO,"4/13/2019, Central Time",558045,539203,586530,-28485
SOCO,"4/14/2019, Central Time",537389,510300,570826,-33437
SOCO,"4/15/2019, Central Time",529795,506471,560035,-30240
SOCO,"4/16/2019, Central Time",550502,535749,575192,-24690
SOCO,"4/17/2019, Central Time",564846,545047,578328,-13482
SOCO,"4/18/2019, Central Time",579691,567658,587233,-7542
SOCO,"4/19/2019, Central Time",526941,521865,537590,-10649
SOCO,"4/20/2019, Central Time",505991,489580,507372,-1381
SOCO,"4/21/2019, Central Time",489905,488418,489836,69
SOCO,"4/22/2019, Central Time",549059,525842,555500,-6441
SOCO,"4/23/2019, Central Time",570809,549895,581536,-10727
SOCO,"4/24/2019, Central Time",594972,573915,620672,-25700
SOCO,"4/25/2019, Central Time",567393,564967,594412,-27019
SOCO,"4/26/2019, Central Time",548051,527996,578912,-30861
SOCO,"4/27/2019, Central Time",509883,488856,529330,-19447
SOCO,"4/28/2019, Central Time",535322,496148,557376,-22054
SOCO,"4/29/2019, Central Time",615283,593012,640582,-25299
SOCO,"4/30/2019, Central Time",645863,621880,674783,-28920
SOCO,"5/1/2019, Central Time",656287,635933,679267,-22980
SOCO,"5/2/2019, Central Time",660576,637016,679738,-19162
SOCO,"5/3/2019, Central Time",652837,628349,676959,-24122
SOCO,"5/4/2019, Central Time",597120,583783,602101,-4981
SOCO,"5/5/2019, Central Time",562423,539397,572064,-9641
SOCO,"5/6/2019, Central Time",610510,584084,627855,-17345
SOCO,"5/7/2019, Central Time",642506,619136,658767,-16261
SOCO,"5/8/2019, Central Time",669172,642523,684334,-15162
SOCO,"5/9/2019, Central Time",641362,653494,656764,-15402
SOCO,"5/10/2019, Central Time",639469,617948,670575,-31106
SOCO,"5/11/2019, Central Time",598583,585381,612399,-13816
SOCO,"5/12/2019, Central Time",548827,543762,566261,-17434
SOCO,"5/13/2019, Central Time",596529,559818,610409,-13880
SOCO,"5/14/2019, Central Time",567642,545596,580150,-12508
SOCO,"5/15/2019, Central Time",580053,565726,599356,-19303
SOCO,"5/16/2019, Central Time",642295,607568,649178,-6883
SOCO,"5/17/2019, Central Time",676073,649239,675460,613
SOCO,"5/18/2019, Central Time",668959,631545,670948,-1989
SOCO,"5/19/2019, Central Time",650312,643115,661613,-11301
SOCO,"5/20/2019, Central Time",713758,692631,731117,-17359
SOCO,"5/21/2019, Central Time",734645,716743,747175,-12530
SOCO,"5/22/2019, Central Time",761445,740991,772742,-11297
SOCO,"5/23/2019, Central Time",771686,741632,785461,-13775
SOCO,"5/24/2019, Central Time",776772,755098,786023,-9251
SOCO,"5/25/2019, Central Time",748827,713748,754185,-5358
SOCO,"5/26/2019, Central Time",740677,719660,754070,-13393
SOCO,"5/27/2019, Central Time",745193,715567,763558,-18365
SOCO,"5/28/2019, Central Time",795599,760288,812266,-16667
SOCO,"5/29/2019, Central Time",797925,769987,821880,-23955
SOCO,"5/30/2019, Central Time",795958,763014,830420,-34462
SOCO,"5/31/2019, Central Time",769684,753106,800484,-30800
SOCO,"6/1/2019, Central Time",700353,677248,715091,-14738
SOCO,"6/2/2019, Central Time",691222,671339,701000,-9778
SOCO,"6/3/2019, Central Time",761350,719677,768979,-7629
SOCO,"6/4/2019, Central Time",749783,733263,760705,-10922
SOCO,"6/5/2019, Central Time",715593,723678,741544,-25951
SOCO,"6/6/2019, Central Time",665382,640302,707049,-41667
SOCO,"6/7/2019, Central Time",690189,667513,723420,-33231
SOCO,"6/8/2019, Central Time",622547,614191,650942,-28395
SOCO,"6/9/2019, Central Time",628027,600407,652920,-24893
SOCO,"6/10/2019, Central Time",700940,662626,728237,-27297
SOCO,"6/11/2019, Central Time",701822,692731,713507,-11685
SOCO,"6/12/2019, Central Time",645811,638400,656828,-11017
SOCO,"6/13/2019, Central Time",646517,612348,669310,-22793
SOCO,"6/14/2019, Central Time",625329,612746,653727,-28398
SOCO,"6/15/2019, Central Time",650745,615581,671075,-20330
SOCO,"6/16/2019, Central Time",705770,667544,715611,-9841
SOCO,"6/17/2019, Central Time",775068,745613,775980,-912
SOCO,"6/18/2019, Central Time",720878,706742,730909,-10031
SOCO,"6/19/2019, Central Time",754409,729341,762829,-8420
SOCO,"6/20/2019, Central Time",769882,742034,784249,-14366
SOCO,"6/21/2019, Central Time",802710,766228,811475,-8765
SOCO,"6/22/2019, Central Time",754844,734061,761413,-6569
SOCO,"6/23/2019, Central Time",714929,712968,731084,-16155
SOCO,"6/24/2019, Central Time",773342,751392,789793,-16451
SOCO,"6/25/2019, Central Time",769931,751818,792056,-22125
SOCO,"6/26/2019, Central Time",752279,753741,777627,-25348
SOCO,"6/27/2019, Central Time",756934,740923,773886,-16952
SOCO,"6/28/2019, Central Time",750542,722404,765988,-15446
SOCO,"6/29/2019, Central Time",697590,680131,713338,-15748
SOCO,"6/30/2019, Central Time",724399,685382,742137,-17738
SOCO,"7/1/2019, Central Time",811655,786733,827569,-15914
SOCO,"7/2/2019, Central Time",844028,804541,859753,-15725
SOCO,"7/3/2019, Central Time",807023,822153,830805,-23782
SOCO,"7/4/2019, Central Time",770636,755525,784818,-14182
SOCO,"7/5/2019, Central Time",776007,747575,791501,-15494
SOCO,"7/6/2019, Central Time",757605,736616,771368,-13763
SOCO,"7/7/2019, Central Time",760370,727012,770933,-10563
SOCO,"7/8/2019, Central Time",812370,785781,822031,-9661
SOCO,"7/9/2019, Central Time",833647,799574,842689,-9042
SOCO,"7/10/2019, Central Time",830833,804862,857097,-26264
SOCO,"7/11/2019, Central Time",821705,794125,840276,-18571
SOCO,"7/12/2019, Central Time",806770,773232,817359,-10589
SOCO,"7/13/2019, Central Time",724930,702878,743685,-18755
SOCO,"7/14/2019, Central Time",730919,696334,752962,-22043
SOCO,"7/15/2019, Central Time",804698,783990,822737,-18039
SOCO,"7/16/2019, Central Time",843473,799933,861561,-18088
SOCO,"7/17/2019, Central Time",822156,812226,833945,-11789
SOCO,"7/18/2019, Central Time",810177,797331,827050,-16873
SOCO,"7/19/2019, Central Time",764022,786415,794824,-30802
SOCO,"7/20/2019, Central Time",714159,688042,739238,-25079
SOCO,"7/21/2019, Central Time",734982,684799,760268,-25286
SOCO,"7/22/2019, Central Time",798645,756614,817317,-18672
SOCO,"7/23/2019, Central Time",741424,719138,756208,-14784
SOCO,"7/24/2019, Central Time",704926,686963,712924,-7998
SOCO,"7/25/2019, Central Time",707996,679522,722422,-14426
SOCO,"7/26/2019, Central Time",719137,688262,738992,-19855
SOCO,"7/27/2019, Central Time",706347,679808,726641,-20294
SOCO,"7/28/2019, Central Time",706237,673872,727667,-21430
SOCO,"7/29/2019, Central Time",769006,735150,784909,-15903
SOCO,"7/30/2019, Central Time",776453,737993,789245,-12792
SOCO,"7/31/2019, Central Time",786023,751594,797886,-11863
SOCO,"8/1/2019, Central Time",771727,762990,783441,-11714
SOCO,"8/2/2019, Central Time",735081,723030,752287,-17206
SOCO,"8/3/2019, Central Time",714799,687055,738846,-24047
SOCO,"8/4/2019, Central Time",695856,672184,723595,-27739
SOCO,"8/5/2019, Central Time",749343,719613,765773,-16430
SOCO,"8/6/2019, Central Time",789747,761711,802935,-13188
SOCO,"8/7/2019, Central Time",826877,784716,829339,-2462
SOCO,"8/8/2019, Central Time",832014,808241,832172,-158
SOCO,"8/9/2019, Central Time",834620,795970,835224,-604
SOCO,"8/10/2019, Central Time",799514,774782,805009,-5495
SOCO,"8/11/2019, Central Time",799327,761426,802871,-3544
SOCO,"8/12/2019, Central Time",867793,836087,877260,-9467
SOCO,"8/13/2019, Central Time",898303,845832,911300,-12997
SOCO,"8/14/2019, Central Time",846094,845623,859877,-13783
SOCO,"8/15/2019, Central Time",819479,810715,827617,-8138
SOCO,"8/16/2019, Central Time",804992,787559,807737,-2745
SOCO,"8/17/2019, Central Time",779776,756364,786137,-6361
SOCO,"8/18/2019, Central Time",776244,751307,784974,-8730
SOCO,"8/19/2019, Central Time",787320,750786,803282,-15962
SOCO,"8/20/2019, Central Time",783602,739493,795214,-11612
SOCO,"8/21/2019, Central Time",809987,768407,823807,-13820
SOCO,"8/22/2019, Central Time",822521,776826,831432,-8911
SOCO,"8/23/2019, Central Time",803137,771269,805432,-2295
SOCO,"8/24/2019, Central Time",743451,714675,749416,-5965
SOCO,"8/25/2019, Central Time",651545,633326,675954,-24409
SOCO,"8/26/2019, Central Time",672254,651939,693494,-21240
SOCO,"8/27/2019, Central Time",716506,695492,733309,-16803
SOCO,"8/28/2019, Central Time",762542,724714,776284,-13742
SOCO,"8/29/2019, Central Time",730666,702675,745729,-15063
SOCO,"8/30/2019, Central Time",712207,688318,724550,-12343
SOCO,"8/31/2019, Central Time",690469,651487,712156,-21687
SOCO,"9/1/2019, Central Time",686440,655682,709364,-22924
SOCO,"9/2/2019, Central Time",716106,696105,733165,-17059
SOCO,"9/3/2019, Central Time",728630,756106,736778,-8148
SOCO,"9/4/2019, Central Time",799117,778638,809192,-10075
SOCO,"9/5/2019, Central Time",806984,763300,816243,-9259
SOCO,"9/6/2019, Central Time",760762,734538,789508,-28746
SOCO,"9/7/2019, Central Time",771084,731280,799309,-28225
SOCO,"9/8/2019, Central Time",771513,748520,798201,-26688
SOCO,"9/9/2019, Central Time",814232,790336,843315,-29083
SOCO,"9/10/2019, Central Time",812101,789635,844707,-32606
SOCO,"9/11/2019, Central Time",807695,774513,842669,34974
SOCO,"9/12/2019, Central Time",810179,785428,840856,30677
SOCO,"9/13/2019, Central Time",801522,771471,815357,13835
SOCO,"9/14/2019, Central Time",730774,684771,743640,12866
SOCO,"9/15/2019, Central Time",733317,700919,750987,17670
SOCO,"9/16/2019, Central Time",790761,764271,823505,32744
SOCO,"9/17/2019, Central Time",810441,786695,832561,22120
SOCO,"9/18/2019, Central Time",783236,761347,805935,22699
SOCO,"9/19/2019, Central Time",710101,690737,720828,10727
SOCO,"9/20/2019, Central Time",656935,646005,678599,21664
SOCO,"9/21/2019, Central Time",638572,619198,654455,15883
SOCO,"9/22/2019, Central Time",635327,619269,653418,18091
SOCO,"9/23/2019, Central Time",697458,671293,712075,14617
SOCO,"9/24/2019, Central Time",742661,723966,757420,14759
SOCO,"9/25/2019, Central Time",744491,720883,760321,15830
SOCO,"9/26/2019, Central Time",782633,732056,787163,4530
SOCO,"9/27/2019, Central Time",788013,763881,782522,-5491
SOCO,"9/28/2019, Central Time",744015,719926,765334,21319
SOCO,"9/29/2019, Central Time",732451,711209,746964,14513
SOCO,"9/30/2019, Central Time",787396,765062,786912,-484
SOCO,"10/1/2019, Central Time",801022,762680,795986,-5036
SOCO,"10/2/2019, Central Time",805251,786760,803033,-2218
SOCO,"10/3/2019, Central Time",809119,797511,800746,-8373
SOCO,"10/4/2019, Central Time",789079,762067,779856,-9223
SOCO,"10/5/2019, Central Time",672183,646880,674387,2204
SOCO,"10/6/2019, Central Time",619544,586061,637457,17913
SOCO,"10/7/2019, Central Time",658240,642674,673993,15753
SOCO,"10/8/2019, Central Time",659872,622419,672476,12604
SOCO,"10/9/2019, Central Time",633118,606091,646761,13643
SOCO,"10/10/2019, Central Time",626416,599603,632254,5838
SOCO,"10/11/2019, Central Time",607046,582817,620675,13629
SOCO,"10/12/2019, Central Time",549596,520691,572604,23008
SOCO,"10/13/2019, Central Time",521848,495094,546065,24217
SOCO,"10/14/2019, Central Time",579292,560032,597278,17986
SOCO,"10/15/2019, Central Time",578574,555049,606511,27937
SOCO,"10/16/2019, Central Time",578628,562636,608263,29635
SOCO,"10/17/2019, Central Time",530151,544358,566631,36480
SOCO,"10/18/2019, Central Time",523062,522948,554876,31814
SOCO,"10/19/2019, Central Time",511291,480330,551531,40240
SOCO,"10/20/2019, Central Time",511309,498781,548590,37281
SOCO,"10/21/2019, Central Time",564864,543748,585191,20327
SOCO,"10/22/2019, Central Time",560116,536962,601251,41135
SOCO,"10/23/2019, Central Time",466903,530156,511614,44711
SOCO,"10/24/2019, Central Time",543451,528323,590055,46604
SOCO,"10/25/2019, Central Time",507134,529090,549581,
SOCO,"10/26/2019, Central Time",545387,516310,565184,19797
SOCO,"10/27/2019, Central Time",515408,485063,539354,23946
SOCO,"10/28/2019, Central Time",499688,529387,531162,31473
SOCO,"10/29/2019, Central Time",552293,534134,581490,29197
SOCO,"10/30/2019, Central Time",573691,555013,592733,19042
SOCO,"10/31/2019, Central Time",574312,560099,600081,25769
SOCO,"11/1/2019, Central Time",585965,597720,584319,-1646
SOCO,"11/2/2019, Central Time",556807,550318,561238,4431
SOCO,"11/3/2019, Central Time",568819,556227,576602,7783
SOCO,"11/4/2019, Central Time",575530,572309,583704,8174
SOCO,"11/5/2019, Central Time",549106,535551,590465,41359
SOCO,"11/6/2019, Central Time",552437,532481,588353,35916
SOCO,"11/7/2019, Central Time",548707,530904,594325,45618
SOCO,"11/8/2019, Central Time",559369,545163,615875,56506
SOCO,"11/9/2019, Central Time",581578,559976,614982,33404
SOCO,"11/10/2019, Central Time",559827,548605,596825,36998
SOCO,"11/11/2019, Central Time",571910,558152,611619,39709
SOCO,"11/12/2019, Central Time",664162,635062,684488,20326
SOCO,"11/13/2019, Central Time",766725,754873,743134,-23591
SOCO,"11/14/2019, Central Time",711519,693044,724494,12975
SOCO,"11/15/2019, Central Time",653665,628422,677843,24178
SOCO,"11/16/2019, Central Time",603247,579031,633477,30230
SOCO,"11/17/2019, Central Time",565536,549748,609066,43530
SOCO,"11/18/2019, Central Time",586492,575026,625884,39392
SOCO,"11/19/2019, Central Time",602003,579517,641129,39126
SOCO,"11/20/2019, Central Time",607373,582383,652293,44920
SOCO,"11/21/2019, Central Time",594653,574794,643298,48645
SOCO,"11/22/2019, Central Time",556742,541365,604133,47391
SOCO,"11/23/2019, Central Time",513999,496272,557405,43406
SOCO,"11/24/2019, Central Time",551519,539101,585900,34381
SOCO,"11/25/2019, Central Time",626514,603333,657720,31206
SOCO,"11/26/2019, Central Time",602115,577658,634212,32097
SOCO,"11/27/2019, Central Time",545109,533387,574416,29307
SOCO,"11/28/2019, Central Time",503048,484091,528312,25264
SOCO,"11/29/2019, Central Time",492350,484618,522086,29736
SOCO,"11/30/2019, Central Time",490432,467920,511445,21013
SOCO,"12/1/2019, Central Time",492147,471127,517437,25290
SOCO,"12/2/2019, Central Time",647089,610991,667967,20878
SOCO,"12/3/2019, Central Time",712733,694375,723181,10448
SOCO,"12/4/2019, Central Time",671057,655102,692931,21874
SOCO,"12/5/2019, Central Time",633357,606907,645854,12497
SOCO,"12/6/2019, Central Time",610376,581302,631112,20736
SOCO,"12/7/2019, Central Time",545811,531605,569799,23988
SOCO,"12/8/2019, Central Time",541522,523306,568986,27464
SOCO,"12/9/2019, Central Time",578974,549738,600716,21742
SOCO,"12/10/2019, Central Time",586678,558468,617887,31209
SOCO,"12/11/2019, Central Time",674703,630458,697011,22308
SOCO,"12/12/2019, Central Time",714377,691585,721275,6898
SOCO,"12/13/2019, Central Time",680174,635681,693087,12913
SOCO,"12/14/2019, Central Time",595753,576736,616904,21151
SOCO,"12/15/2019, Central Time",577739,559038,601824,24085
SOCO,"12/16/2019, Central Time",566469,560817,604357,37888
SOCO,"12/17/2019, Central Time",578137,592009,613716,35579
SOCO,"12/18/2019, Central Time",737309,741057,741832,4523
SOCO,"12/19/2019, Central Time",755661,750293,744795,-10866
SOCO,"12/20/2019, Central Time",712850,690791,717332,4482
SOCO,"12/21/2019, Central Time",617198,596044,641939,24741
SOCO,"12/22/2019, Central Time",616351,580862,633562,17211
SOCO,"12/23/2019, Central Time",588016,599895,600277,12261
SOCO,"12/24/2019, Central Time",512356,500388,535229,22873
SOCO,"12/25/2019, Central Time",492501,491696,513275,20774
SOCO,"12/26/2019, Central Time",537283,512346,568266,30983
SOCO,"12/27/2019, Central Time",524913,507238,558232,33319
SOCO,"12/28/2019, Central Time",491529,480912,524678,33149
SOCO,"12/29/2019, Central Time",481664,473187,511441,29777
SOCO,"12/30/2019, Central Time",523615,517788,550592,26977
SOCO,"12/31/2019, Central Time",593995,584622,615004,21009
SOCO,"1/1/2020, Central Time",,,,
