"BA Code","Timestamp (Hour Ending)","Demand (MWh)","Demand Forecast (MWh)","Net Generation (MWh)","Total Interchange (MWh)"
SOCO,"1/1/2020, Central Time",588214,562224,589559,1345
SOCO,"1/2/2020, Central Time",596736,584729,608765,12029
SOCO,"1/3/2020, Central Time",555270,535040,575379,20109
SOCO,"1/4/2020, Central Time",543011,507869,557659,14648
SOCO,"1/5/2020, Central Time",627559,602508,641492,13933
SOCO,"1/6/2020, Central Time",636886,608042,655772,18886
SOCO,"1/7/2020, Central Time",607746,596073,630912,23166
SOCO,"1/8/2020, Central Time",666289,649729,665606,-683
SOCO,"1/9/2020, Central Time",642155,617687,647358,5203
SOCO,"1/10/2020, Central Time",554230,534777,568640,14410
SOCO,"1/11/2020, Central Time",505265,485828,511892,6627
SOCO,"1/12/2020, Central Time",506555,485752,520589,14034
SOCO,"1/13/2020, Central Time",551070,527732,561183,10113
SOCO,"1/14/2020, Central Time",551517,539412,564118,12601
SOCO,"1/15/2020, Central Time",550084,544275,559653,9569
SOCO,"1/16/2020, Central Time",551745,540373,570003,18258
SOCO,"1/17/2020, Central Time",589957,561994,598396,8439
SOCO,"1/18/2020, Central Time",575958,559273,579232,3274
SOCO,"1/19/2020, Central Time",584485,578757,584752,267
SOCO,"1/20/2020, Central Time",767478,732188,740476,-27002
SOCO,"1/21/2020, Central Time",831007,820846,792740,-38267
SOCO,"1/22/2020, Central Time",794350,787146,758285,-36065
SOCO,"1/23/2020, Central Time",701979,670969,689495,-12484
SOCO,"1/24/2020, Central Time",620518,606360,625871,5353
SOCO,"1/25/2020, Central Time",635941,613084,633863,-2078
SOCO,"1/26/2020, Central Time",635537,612236,639421,3884
SOCO,"1/27/2020, Central Time",635836,614083,635318,-518
SOCO,"1/28/2020, Central Time",654580,634030,648933,-5647
SOCO,"1/29/2020, Central Time",670743,627504,666525,-4218
SOCO,"1/30/2020, Central Time",649572,623243,654086,4514
SOCO,"1/31/2020, Central Time",660062,634461,660527,465
SOCO,"2/1/2020, Central Time",628651,603381,614419,-14232
SOCO,"2/2/2020, Central Time",605552,585080,588056,-17496
SOCO,"2/3/2020, Central Time",589430,564923,584992,-4438
SOCO,"2/4/2020, Central Time",546694,537170,554000,7306
SOCO,"2/5/2020, Central Time",539400,530367,551674,12274
SOCO,"2/6/2020, Central Time",554540,531902,565794,11254
SOCO,"2/7/2020, Central Time",672468,643828,645727,-26741
SOCO,"2/8/2020, Central Time",683338,638815,658091,-25247
SOCO,"2/9/2020, Central Time",616863,594994,594823,-22040
SOCO,"2/10/2020, Central Time",613468,579941,611697,-1771
SOCO,"2/11/2020, Central Time",564011,553383,572251,8240
SOCO,"2/12/2020, Central Time",557639,541201,563912,6273
SOCO,"2/13/2020, Central Time",562716,542371,572742,10026
SOCO,"2/14/2020, Central Time",633193,644808,622475,-10718
SOCO,"2/15/2020, Central Time",624422,617997,621062,-3360
SOCO,"2/16/2020, Central Time",591611,562773,599844,8233
SOCO,"2/17/2020, Central Time",594983,572073,600892,5909
SOCO,"2/18/2020, Central Time",569888,543750,584511,14623
SOCO,"2/19/2020, Central Time",573695,551856,593863,20168
SOCO,"2/20/2020, Central Time",662800,619628,672796,9996
SOCO,"2/21/2020, Central Time",711253,686582,689150,-22103
SOCO,"2/22/2020, Central Time",682433,662261,657387,-25046
SOCO,"2/23/2020, Central Time",620966,617179,627273,6307
SOCO,"2/24/2020, Central Time",612316,586934,625348,13032
SOCO,"2/25/2020, Central Time",565281,555407,585646,20365
SOCO,"2/26/2020, Central Time",608136,596049,627852,19716
SOCO,"2/27/2020, Central Time",690189,680822,687168,-3021
SOCO,"2/28/2020, Central Time",688015,673074,686460,-1555
SOCO,"2/29/2020, Central Time",615796,597317,625638,9842
SOCO,"3/1/2020, Central Time",587993,566295,595770,7777
SOCO,"3/2/2020, Central Time",583516,563705,580642,-2874
SOCO,"3/3/2020, Central Time",551400,530166,553856,2456
SOCO,"3/4/2020, Central Time",559474,535846,564303,4829
SOCO,"3/5/2020, Central Time",592463,568633,593624,1161
SOCO,"3/6/2020, Central Time",598985,577549,593671,-5314
SOCO,"3/7/2020, Central Time",598947,593456,577311,-21636
SOCO,"3/8/2020, Central Time",548937,544680,523332,-25605
SOCO,"3/9/2020, Central Time",571280,554201,553287,-17993
SOCO,"3/10/2020, Central Time",545610,530242,539984,-5626
SOCO,"3/11/2020, Central Time",544184,529942,538585,-5599
SOCO,"3/12/2020, Central Time",547841,532658,544637,-3204
SOCO,"3/13/2020, Central Time",536396,524622,526197,-10199
SOCO,"3/14/2020, Central Time",514091,496955,518392,4301
SOCO,"3/15/2020, Central Time",501027,484666,507536,6509
SOCO,"3/16/2020, Central Time",547690,526476,559723,12033
SOCO,"3/17/2020, Central Time",556529,540742,566813,10284
SOCO,"3/18/2020, Central Time",557148,545650,565980,8832
SOCO,"3/19/2020, Central Time",569883,556788,578048,8165
SOCO,"3/20/2020, Central Time",564007,548581,573329,9322
SOCO,"3/21/2020, Central Time",503572,494909,512045,8473
SOCO,"3/22/2020, Central Time",484172,473856,499464,15292
SOCO,"3/23/2020, Central Time",541530,531451,553464,11934
SOCO,"3/24/2020, Central Time",552795,546180,556060,3265
SOCO,"3/25/2020, Central Time",557383,530703,559746,2363
SOCO,"3/26/2020, Central Time",550620,534921,549620,-1000
SOCO,"3/27/2020, Central Time",569372,554593,563605,-5767
SOCO,"3/28/2020, Central Time",563855,541196,556372,-7483
SOCO,"3/29/2020, Central Time",540086,519637,539801,-285
SOCO,"3/30/2020, Central Time",523689,526163,527160,3471
SOCO,"3/31/2020, Central Time",503883,501550,512592,8709
SOCO,"4/1/2020, Central Time",506777,527141,512638,5861
SOCO,"4/2/2020, Central Time",513437,498885,515307,1870
SOCO,"4/3/2020, Central Time",504114,499360,514206,10092
SOCO,"4/4/2020, Central Time",478817,463741,489468,10651
SOCO,"4/5/2020, Central Time",485802,466670,491364,5562
SOCO,"4/6/2020, Central Time",532224,519252,537859,5635
SOCO,"4/7/2020, Central Time",530710,531734,540636,9926
SOCO,"4/8/2020, Central Time",560189,529909,566684,6495
SOCO,"4/9/2020, Central Time",569155,547461,562037,-7118
SOCO,"4/10/2020, Central Time",475394,477336,476411,1017
SOCO,"4/11/2020, Central Time",469384,453665,479655,10271
SOCO,"4/12/2020, Central Time",471839,462067,480661,8822
SOCO,"4/13/2020, Central Time",512574,521306,516317,3743
SOCO,"4/14/2020, Central Time",507986,498594,534110,26124
SOCO,"4/15/2020, Central Time",493606,494716,521240,27634
SOCO,"4/16/2020, Central Time",502518,480098,506162,3644
SOCO,"4/17/2020, Central Time",498808,475256,504290,5482
SOCO,"4/18/2020, Central Time",480847,445662,490346,9499
SOCO,"4/19/2020, Central Time",482773,442501,497584,14811
SOCO,"4/20/2020, Central Time",506498,503160,516577,10079
SOCO,"4/21/2020, Central Time",512034,507626,524025,11991
SOCO,"4/22/2020, Central Time",504461,497101,516460,11999
SOCO,"4/23/2020, Central Time",501157,494345,519007,17850
SOCO,"4/24/2020, Central Time",502957,491872,520693,17736
SOCO,"4/25/2020, Central Time",496845,476267,512500,15655
SOCO,"4/26/2020, Central Time",463078,457731,485676,22598
SOCO,"4/27/2020, Central Time",501042,485434,524237,23195
SOCO,"4/28/2020, Central Time",515350,504220,543096,27746
SOCO,"4/29/2020, Central Time",510893,496240,535095,24202
SOCO,"4/30/2020, Central Time",492942,477662,527986,35044
SOCO,"5/1/2020, Central Time",490185,473845,526750,36565
SOCO,"5/2/2020, Central Time",487733,465773,519785,32052
SOCO,"5/3/2020, Central Time",515082,499135,551935,36853
SOCO,"5/4/2020, Central Time",600176,572824,627403,27227
SOCO,"5/5/2020, Central Time",613231,580509,641049,27818
SOCO,"5/6/2020, Central Time",537274,515255,574195,36921
SOCO,"5/7/2020, Central Time",503813,482551,527591,23778
SOCO,"5/8/2020, Central Time",498567,473687,528631,30064
SOCO,"5/9/2020, Central Time",467561,448575,506073,38512
SOCO,"5/10/2020, Central Time",473318,453023,505558,32240
SOCO,"5/11/2020, Central Time",510540,499944,543437,32897
SOCO,"5/12/2020, Central Time",523311,510843,556660,33349
SOCO,"5/13/2020, Central Time",544610,525752,580613,36003
SOCO,"5/14/2020, Central Time",573278,541530,600757,27479
SOCO,"5/15/2020, Central Time",581258,571290,614774,33516
SOCO,"5/16/2020, Central Time",580500,561275,607842,27342
SOCO,"5/17/2020, Central Time",580298,555982,608853,28555
SOCO,"5/18/2020, Central Time",595671,578457,622666,26995
SOCO,"5/19/2020, Central Time",583507,551428,607985,24478
SOCO,"5/20/2020, Central Time",535126,517629,561288,26162
SOCO,"5/21/2020, Central Time",559562,540402,593074,33512
SOCO,"5/22/2020, Central Time",611235,585648,644584,33349
SOCO,"5/23/2020, Central Time",612998,591847,637566,24568
SOCO,"5/24/2020, Central Time",613332,592538,628019,14687
SOCO,"5/25/2020, Central Time",603054,591969,618760,15706
SOCO,"5/26/2020, Central Time",579756,589076,608632,28876
SOCO,"5/27/2020, Central Time",575142,568910,610039,34897
SOCO,"5/28/2020, Central Time",639037,601100,670173,31136
SOCO,"5/29/2020, Central Time",649006,614452,673664,24658
SOCO,"5/30/2020, Central Time",631966,581568,642662,10696
SOCO,"5/31/2020, Central Time",609706,557403,627113,17407
SOCO,"6/1/2020, Central Time",647039,619567,653848,6809
SOCO,"6/2/2020, Central Time",672165,647963,682975,10810
SOCO,"6/3/2020, Central Time",686809,647206,698349,11540
SOCO,"6/4/2020, Central Time",701635,655191,713124,11489
SOCO,"6/5/2020, Central Time",684983,675089,703781,18798
SOCO,"6/6/2020, Central Time",645026,631605,659314,14288
SOCO,"6/7/2020, Central Time",646444,617217,666012,19568
SOCO,"6/8/2020, Central Time",710100,674162,725055,14955
SOCO,"6/9/2020, Central Time",715552,690596,734430,18878
SOCO,"6/10/2020, Central Time",719954,690358,745517,25563
SOCO,"6/11/2020, Central Time",703240,684598,718320,15080
SOCO,"6/12/2020, Central Time",678935,675346,688546,9611
SOCO,"6/13/2020, Central Time",643853,610401,654881,11028
SOCO,"6/14/2020, Central Time",618946,593370,633889,14943
SOCO,"6/15/2020, Central Time",632234,619266,644233,11999
SOCO,"6/16/2020, Central Time",595615,596724,620681,25066
SOCO,"6/17/2020, Central Time",593208,577020,614915,21707
SOCO,"6/18/2020, Central Time",642850,608477,663446,20596
SOCO,"6/19/2020, Central Time",680592,648889,704136,23544
SOCO,"6/20/2020, Central Time",684193,645925,696873,12680
SOCO,"6/21/2020, Central Time",675641,657757,686003,10362
SOCO,"6/22/2020, Central Time",693076,684929,698864,5788
SOCO,"6/23/2020, Central Time",701815,681119,713465,11650
SOCO,"6/24/2020, Central Time",674425,663914,687078,12653
SOCO,"6/25/2020, Central Time",688079,631833,712700,24621
SOCO,"6/26/2020, Central Time",684512,676925,713206,28694
SOCO,"6/27/2020, Central Time",651526,649509,685688,34162
SOCO,"6/28/2020, Central Time",711732,664518,736825,25093
SOCO,"6/29/2020, Central Time",785582,761828,796916,11334
SOCO,"6/30/2020, Central Time",755417,752313,766261,10844
SOCO,"7/1/2020, Central Time",692516,685705,714118,21602
SOCO,"7/2/2020, Central Time",724209,716962,743215,19006
SOCO,"7/3/2020, Central Time",737362,701253,744554,7192
SOCO,"7/4/2020, Central Time",698816,689629,723558,24742
SOCO,"7/5/2020, Central Time",693875,683140,720010,26135
SOCO,"7/6/2020, Central Time",697802,684041,734622,36820
SOCO,"7/7/2020, Central Time",705770,675716,734458,28688
SOCO,"7/8/2020, Central Time",727804,691495,754883,27079
SOCO,"7/9/2020, Central Time",759085,734491,791153,32068
SOCO,"7/10/2020, Central Time",794711,739585,811865,17154
SOCO,"7/11/2020, Central Time",757878,724716,771587,13709
SOCO,"7/12/2020, Central Time",692701,713030,721044,28343
SOCO,"7/13/2020, Central Time",767799,737276,793150,25351
SOCO,"7/14/2020, Central Time",802737,774788,827532,24795
SOCO,"7/15/2020, Central Time",790451,784329,820222,29771
SOCO,"7/16/2020, Central Time",799565,767159,828155,28590
SOCO,"7/17/2020, Central Time",827110,792285,847740,20630
SOCO,"7/18/2020, Central Time",793552,766233,809719,16167
SOCO,"7/19/2020, Central Time",785624,761553,805809,20185
SOCO,"7/20/2020, Central Time",843282,819829,876782,33500
SOCO,"7/21/2020, Central Time",807292,782769,843639,36347
SOCO,"7/22/2020, Central Time",799230,783432,836246,37016
SOCO,"7/23/2020, Central Time",803007,783938,831036,28029
SOCO,"7/24/2020, Central Time",753071,722527,780116,27045
SOCO,"7/25/2020, Central Time",703248,704046,729510,26262
SOCO,"7/26/2020, Central Time",711575,685090,742085,30510
SOCO,"7/27/2020, Central Time",784353,757780,812694,28341
SOCO,"7/28/2020, Central Time",774038,754700,806354,32316
SOCO,"7/29/2020, Central Time",753613,721925,787768,34155
SOCO,"7/30/2020, Central Time",784642,749580,805502,20860
SOCO,"7/31/2020, Central Time",810075,771915,832206,22131
SOCO,"8/1/2020, Central Time",766385,734910,786955,20570
SOCO,"8/2/2020, Central Time",756858,721588,769211,12353
SOCO,"8/3/2020, Central Time",770789,764276,786551,15762
SOCO,"8/4/2020, Central Time",772147,747222,776881,4734
SOCO,"8/5/2020, Central Time",789738,757337,797362,7624
SOCO,"8/6/2020, Central Time",792819,762433,805926,13107
SOCO,"8/7/2020, Central Time",782489,757911,793961,11472
SOCO,"8/8/2020, Central Time",756763,734669,761299,4536
SOCO,"8/9/2020, Central Time",769837,737174,780143,10306
SOCO,"8/10/2020, Central Time",780362,762004,806051,25689
SOCO,"8/11/2020, Central Time",787657,776794,809758,22101
SOCO,"8/12/2020, Central Time",792236,774069,803428,11192
SOCO,"8/13/2020, Central Time",793515,761074,811957,18442
SOCO,"8/14/2020, Central Time",741046,739144,767421,26375
SOCO,"8/15/2020, Central Time",707850,693518,730225,22375
SOCO,"8/16/2020, Central Time",732111,694257,740658,8547
SOCO,"8/17/2020, Central Time",777458,753259,788658,11200
SOCO,"8/18/2020, Central Time",767642,737931,775700,8058
SOCO,"8/19/2020, Central Time",747682,724633,749304,1622
SOCO,"8/20/2020, Central Time",691207,692770,707550,16343
SOCO,"8/21/2020, Central Time",679022,652522,694568,15546
SOCO,"8/22/2020, Central Time",664361,629030,692457,28096
SOCO,"8/23/2020, Central Time",670527,642719,700260,29733
SOCO,"8/24/2020, Central Time",711974,700575,743267,31293
SOCO,"8/25/2020, Central Time",708775,695060,741777,33002
SOCO,"8/26/2020, Central Time",765658,739776,788358,22700
SOCO,"8/27/2020, Central Time",786120,778798,809868,23748
SOCO,"8/28/2020, Central Time",760839,743651,778381,17542
SOCO,"8/29/2020, Central Time",718565,699487,743930,25365
SOCO,"8/30/2020, Central Time",730804,718425,738963,8159
SOCO,"8/31/2020, Central Time",759561,732211,763604,4043
SOCO,"9/1/2020, Central Time",801030,778213,798598,-2432
SOCO,"9/2/2020, Central Time",814142,788892,825948,11806
SOCO,"9/3/2020, Central Time",809728,786942,822193,12465
SOCO,"9/4/2020, Central Time",804829,774512,824940,20111
SOCO,"9/5/2020, Central Time",721270,697015,732261,10991
SOCO,"9/6/2020, Central Time",646991,620174,655873,8882
SOCO,"9/7/2020, Central Time",641702,621968,656738,15036
SOCO,"9/8/2020, Central Time",700980,678011,710447,9467
SOCO,"9/9/2020, Central Time",708698,681483,726272,17574
SOCO,"9/10/2020, Central Time",738999,711074,764753,25754
SOCO,"9/11/2020, Central Time",759110,724947,778740,19630
SOCO,"9/12/2020, Central Time",716650,690405,735778,19128
SOCO,"9/13/2020, Central Time",700592,667453,721461,20869
SOCO,"9/14/2020, Central Time",729499,702395,757081,27582
SOCO,"9/15/2020, Central Time",645090,624097,676702,31612
SOCO,"9/16/2020, Central Time",547051,571639,589684,42633
SOCO,"9/17/2020, Central Time",598220,605892,639059,40839
SOCO,"9/18/2020, Central Time",616615,590233,657813,41198
SOCO,"9/19/2020, Central Time",536703,521019,558783,22080
SOCO,"9/20/2020, Central Time",496135,496873,516722,20587
SOCO,"9/21/2020, Central Time",528246,524547,549149,20903
SOCO,"9/22/2020, Central Time",537199,517818,560918,23719
SOCO,"9/23/2020, Central Time",571708,520932,601831,30123
SOCO,"9/24/2020, Central Time",582367,565607,608244,25877
SOCO,"9/25/2020, Central Time",609834,592783,626003,16169
SOCO,"9/26/2020, Central Time",597489,561631,613248,15759
SOCO,"9/27/2020, Central Time",601363,564418,614262,12899
SOCO,"9/28/2020, Central Time",660716,625462,663862,3146
SOCO,"9/29/2020, Central Time",555742,541225,583972,28230
SOCO,"9/30/2020, Central Time",537835,518736,562763,24928
SOCO,"10/1/2020, Central Time",557275,534244,583507,26232
SOCO,"10/2/2020, Central Time",523251,512126,545521,22270
SOCO,"10/3/2020, Central Time",489066,470907,515438,26372
SOCO,"10/4/2020, Central Time",484892,476973,513756,28864
SOCO,"10/5/2020, Central Time",545786,534158,564869,19083
SOCO,"10/6/2020, Central Time",570071,550599,581532,11461
SOCO,"10/7/2020, Central Time",618494,584661,621104,2610
SOCO,"10/8/2020, Central Time",620907,613773,621865,958
SOCO,"10/9/2020, Central Time",598428,585256,605235,6807
SOCO,"10/10/2020, Central Time",583928,561613,591781,7853
SOCO,"10/11/2020, Central Time",577211,557606,585697,8486
SOCO,"10/12/2020, Central Time",626740,607823,632857,6117
SOCO,"10/13/2020, Central Time",618630,603735,627257,8627
SOCO,"10/14/2020, Central Time",581262,560402,595996,14734
SOCO,"10/15/2020, Central Time",598537,578334,597653,-884
SOCO,"10/16/2020, Central Time",547368,526476,549840,2472
SOCO,"10/17/2020, Central Time",493664,487507,505922,12258
SOCO,"10/18/2020, Central Time",500900,481630,511542,10642
SOCO,"10/19/2020, Central Time",565084,547019,586614,21530
SOCO,"10/20/2020, Central Time",582771,555873,601979,19208
SOCO,"10/21/2020, Central Time",604923,575468,617864,12941
SOCO,"10/22/2020, Central Time",610373,591675,619054,8681
SOCO,"10/23/2020, Central Time",609006,586805,617645,8639
SOCO,"10/24/2020, Central Time",549469,535259,574179,24710
SOCO,"10/25/2020, Central Time",528916,504460,556284,27368
SOCO,"10/26/2020, Central Time",573191,546543,610624,37433
SOCO,"10/27/2020, Central Time",588955,584168,626260,37305
SOCO,"10/28/2020, Central Time",608694,594394,634167,25473
SOCO,"10/29/2020, Central Time",544973,554019,579616,34643
SOCO,"10/30/2020, Central Time",486081,514759,524132,38051
SOCO,"10/31/2020, Central Time",480416,482764,505408,24992
SOCO,"11/1/2020, Central Time",495911,482722,524292,28381
SOCO,"11/2/2020, Central Time",555098,559947,579387,24289
SOCO,"11/3/2020, Central Time",582593,578402,600230,17637
SOCO,"11/4/2020, Central Time",562420,548950,585064,22644
SOCO,"11/5/2020, Central Time",549533,531511,567490,17957
SOCO,"11/6/2020, Central Time",540482,524055,560297,19815
SOCO,"11/7/2020, Central Time",511778,493191,524930,13152
SOCO,"11/8/2020, Central Time",515371,496213,526998,11627
SOCO,"11/9/2020, Central Time",572380,549798,578248,5868
SOCO,"11/10/2020, Central Time",581648,575573,584198,2550
SOCO,"11/11/2020, Central Time",607318,596720,608383,1065
SOCO,"11/12/2020, Central Time",577245,557517,569098,-8147
SOCO,"11/13/2020, Central Time",534761,512619,542407,7646
SOCO,"11/14/2020, Central Time",502248,482129,505688,3440
SOCO,"11/15/2020, Central Time",505787,483371,507452,1665
SOCO,"11/16/2020, Central Time",558955,542201,567397,8442
SOCO,"11/17/2020, Central Time",589354,571506,595694,6340
SOCO,"11/18/2020, Central Time",601397,590605,608857,7460
SOCO,"11/19/2020, Central Time",604042,582779,611567,7525
SOCO,"11/20/2020, Central Time",564737,559609,580965,16228
SOCO,"11/21/2020, Central Time",515232,504113,528561,13329
SOCO,"11/22/2020, Central Time",503428,492564,516185,12757
SOCO,"11/23/2020, Central Time",551022,540152,556697,5675
SOCO,"11/24/2020, Central Time",589448,570844,598132,8684
SOCO,"11/25/2020, Central Time",554770,539180,567436,12666
SOCO,"11/26/2020, Central Time",499388,486271,509410,10022
SOCO,"11/27/2020, Central Time",495668,476801,510112,14444
SOCO,"11/28/2020, Central Time",485418,479603,501404,15986
SOCO,"11/29/2020, Central Time",511215,485427,521676,10461
SOCO,"11/30/2020, Central Time",634728,605783,645790,11062
SOCO,"12/1/2020, Central Time",750384,708869,741967,-8417
SOCO,"12/2/2020, Central Time",747979,729962,748276,297
SOCO,"12/3/2020, Central Time",689533,672273,704692,15159
SOCO,"12/4/2020, Central Time",610307,585867,627409,17102
SOCO,"12/5/2020, Central Time",615413,594348,619507,4094
SOCO,"12/6/2020, Central Time",594760,580573,605140,10380
SOCO,"12/7/2020, Central Time",662059,642198,673060,11001
SOCO,"12/8/2020, Central Time",739451,711795,752796,13345
SOCO,"12/9/2020, Central Time",693648,675149,715261,21613
SOCO,"12/10/2020, Central Time",629120,608946,644171,15051
SOCO,"12/11/2020, Central Time",603069,577417,610464,7395
SOCO,"12/12/2020, Central Time",535470,517667,533378,-2092
SOCO,"12/13/2020, Central Time",511294,491350,512672,1378
SOCO,"12/14/2020, Central Time",589665,580598,603310,13645
SOCO,"12/15/2020, Central Time",675058,650376,690106,15048
SOCO,"12/16/2020, Central Time",683090,660407,686762,3672
SOCO,"12/17/2020, Central Time",762258,731178,721650,-40608
SOCO,"12/18/2020, Central Time",773793,744695,742275,-31518
SOCO,"12/19/2020, Central Time",690471,684464,686445,-4026
SOCO,"12/20/2020, Central Time",589403,567935,601694,12291
SOCO,"12/21/2020, Central Time",618949,598275,625776,6827
SOCO,"12/22/2020, Central Time",638408,610660,638592,184
SOCO,"12/23/2020, Central Time",627145,605310,632719,5574
SOCO,"12/24/2020, Central Time",607213,581364,606203,-1010
SOCO,"12/25/2020, Central Time",754595,731213,735936,-18659
SOCO,"12/26/2020, Central Time",753601,726352,739601,-14000
SOCO,"12/27/2020, Central Time",688705,662680,679501,-9204
SOCO,"12/28/2020, Central Time",653997,634431,657098,3101
SOCO,"12/29/2020, Central Time",603064,587893,620683,17619
SOCO,"12/30/2020, Central Time",577255,562974,595831,18576
SOCO,"12/31/2020, Central Time",549331,539244,560006,10675
SOCO,"1/1/2021, Central Time",,,,
